"Localidades";"Períodos";"População ";"População Masculina ";"População Feminina ";"Razão de Sexos ";"População Urbana ";"População Rural ";"Grau de Urbanização (Em %)";"Cód. IBGE"
"Adamantina";"2016";"33882";"16352";"17530";"93,28";"32460";"1422";"95,8";3500105
"Adamantina";"2017";"33885";"16346";"17539";"93,2";"32518";"1367";"95,97";3500105
"Adamantina";"2018";"33888";"16339";"17549";"93,11";"32572";"1316";"96,12";3500105
"Adamantina";"2019";"33891";"16333";"17558";"93,02";"32622";"1269";"96,26";3500105
"Adamantina";"2020";"33894";"16326";"17568";"92,93";"32668";"1226";"96,38";3500105
"Adolfo";"2016";"3490";"1739";"1751";"99,31";"3203";"287";"91,78";3500204
"Adolfo";"2017";"3479";"1731";"1748";"99,03";"3200";"279";"91,98";3500204
"Adolfo";"2018";"3469";"1723";"1746";"98,68";"3198";"271";"92,19";3500204
"Adolfo";"2019";"3458";"1715";"1743";"98,39";"3194";"264";"92,37";3500204
"Adolfo";"2020";"3447";"1707";"1740";"98,1";"3189";"258";"92,52";3500204
"Aguaí";"2016";"34242";"17228";"17014";"101,26";"31322";"2920";"91,47";3500303
"Aguaí";"2017";"34578";"17391";"17187";"101,19";"31695";"2883";"91,66";3500303
"Aguaí";"2018";"34919";"17556";"17363";"101,11";"32073";"2846";"91,85";3500303
"Aguaí";"2019";"35261";"17721";"17540";"101,03";"32451";"2810";"92,03";3500303
"Aguaí";"2020";"35608";"17889";"17719";"100,96";"32833";"2775";"92,21";3500303
"Águas da Prata";"2016";"7720";"3799";"3921";"96,89";"7036";"684";"91,14";3500402
"Águas da Prata";"2017";"7739";"3807";"3932";"96,82";"7075";"664";"91,42";3500402
"Águas da Prata";"2018";"7758";"3814";"3944";"96,7";"7113";"645";"91,69";3500402
"Águas da Prata";"2019";"7777";"3822";"3955";"96,64";"7150";"627";"91,94";3500402
"Águas da Prata";"2020";"7797";"3830";"3967";"96,55";"7188";"609";"92,19";3500402
"Águas de Lindóia";"2016";"17954";"8758";"9196";"95,24";"17793";"161";"99,1";3500501
"Águas de Lindóia";"2017";"18058";"8804";"9254";"95,14";"17896";"162";"99,1";3500501
"Águas de Lindóia";"2018";"18163";"8850";"9313";"95,03";"18000";"163";"99,1";3500501
"Águas de Lindóia";"2019";"18268";"8897";"9371";"94,94";"18104";"164";"99,1";3500501
"Águas de Lindóia";"2020";"18374";"8944";"9430";"94,85";"18209";"165";"99,1";3500501
"Águas de Santa Bárbara";"2016";"5801";"2850";"2951";"96,58";"4471";"1330";"77,07";3500550
"Águas de Santa Bárbara";"2017";"5833";"2863";"2970";"96,4";"4506";"1327";"77,25";3500550
"Águas de Santa Bárbara";"2018";"5865";"2876";"2989";"96,22";"4540";"1325";"77,41";3500550
"Águas de Santa Bárbara";"2019";"5899";"2890";"3009";"96,05";"4577";"1322";"77,59";3500550
"Águas de Santa Bárbara";"2020";"5931";"2903";"3028";"95,87";"4611";"1320";"77,74";3500550
"Águas de São Pedro";"2016";"2966";"1387";"1579";"87,84";"2966";"-";"100";3500600
"Águas de São Pedro";"2017";"3004";"1406";"1598";"87,98";"3004";"-";"100";3500600
"Águas de São Pedro";"2018";"3043";"1426";"1617";"88,19";"3043";"-";"100";3500600
"Águas de São Pedro";"2019";"3082";"1446";"1636";"88,39";"3082";"-";"100";3500600
"Águas de São Pedro";"2020";"3122";"1466";"1656";"88,53";"3122";"-";"100";3500600
"Agudos";"2016";"35525";"17539";"17986";"97,51";"34127";"1398";"96,06";3500709
"Agudos";"2017";"35676";"17608";"18068";"97,45";"34299";"1377";"96,14";3500709
"Agudos";"2018";"35828";"17677";"18151";"97,39";"34471";"1357";"96,21";3500709
"Agudos";"2019";"35980";"17746";"18234";"97,32";"34642";"1338";"96,28";3500709
"Agudos";"2020";"36134";"17816";"18318";"97,26";"34815";"1319";"96,35";3500709
"Alambari";"2016";"5426";"2716";"2710";"100,22";"4307";"1119";"79,38";3500758
"Alambari";"2017";"5512";"2757";"2755";"100,07";"4410";"1102";"80,01";3500758
"Alambari";"2018";"5600";"2799";"2801";"99,93";"4516";"1084";"80,64";3500758
"Alambari";"2019";"5689";"2842";"2847";"99,82";"4622";"1067";"81,24";3500758
"Alambari";"2020";"5779";"2885";"2894";"99,69";"4729";"1050";"81,83";3500758
"Alfredo Marcondes";"2016";"3919";"1995";"1924";"103,69";"3458";"461";"88,24";3500808
"Alfredo Marcondes";"2017";"3920";"1996";"1924";"103,74";"3483";"437";"88,85";3500808
"Alfredo Marcondes";"2018";"3923";"1998";"1925";"103,79";"3509";"414";"89,45";3500808
"Alfredo Marcondes";"2019";"3924";"1999";"1925";"103,84";"3531";"393";"89,98";3500808
"Alfredo Marcondes";"2020";"3927";"2001";"1926";"103,89";"3554";"373";"90,5";3500808
"Altair";"2016";"3951";"2108";"1843";"114,38";"3264";"687";"82,61";3500907
"Altair";"2017";"3973";"2117";"1856";"114,06";"3302";"671";"83,11";3500907
"Altair";"2018";"3994";"2125";"1869";"113,7";"3339";"655";"83,6";3500907
"Altair";"2019";"4015";"2134";"1881";"113,45";"3376";"639";"84,08";3500907
"Altair";"2020";"4036";"2142";"1894";"113,09";"3413";"623";"84,56";3500907
"Altinópolis";"2016";"15560";"7758";"7802";"99,44";"14037";"1523";"90,21";3501004
"Altinópolis";"2017";"15558";"7752";"7806";"99,31";"14099";"1459";"90,62";3501004
"Altinópolis";"2018";"15557";"7747";"7810";"99,19";"14160";"1397";"91,02";3501004
"Altinópolis";"2019";"15555";"7741";"7814";"99,07";"14217";"1338";"91,4";3501004
"Altinópolis";"2020";"15553";"7735";"7818";"98,94";"14272";"1281";"91,76";3501004
"Alto Alegre";"2016";"4057";"2077";"1980";"104,9";"3356";"701";"82,72";3501103
"Alto Alegre";"2017";"4047";"2071";"1976";"104,81";"3372";"675";"83,32";3501103
"Alto Alegre";"2018";"4037";"2064";"1973";"104,61";"3386";"651";"83,87";3501103
"Alto Alegre";"2019";"4027";"2058";"1969";"104,52";"3400";"627";"84,43";3501103
"Alto Alegre";"2020";"4017";"2052";"1965";"104,43";"3412";"605";"84,94";3501103
"Alumínio";"2016";"17525";"8818";"8707";"101,27";"14698";"2827";"83,87";3501152
"Alumínio";"2017";"17636";"8869";"8767";"101,16";"14791";"2845";"83,87";3501152
"Alumínio";"2018";"17747";"8920";"8827";"101,05";"14885";"2862";"83,87";3501152
"Alumínio";"2019";"17859";"8971";"8888";"100,93";"14978";"2881";"83,87";3501152
"Alumínio";"2020";"17972";"9023";"8949";"100,83";"15073";"2899";"83,87";3501152
"Álvares Florence";"2016";"3727";"1897";"1830";"103,66";"2662";"1065";"71,42";3501202
"Álvares Florence";"2017";"3700";"1881";"1819";"103,41";"2663";"1037";"71,97";3501202
"Álvares Florence";"2018";"3673";"1864";"1809";"103,04";"2663";"1010";"72,5";3501202
"Álvares Florence";"2019";"3647";"1848";"1799";"102,72";"2663";"984";"73,02";3501202
"Álvares Florence";"2020";"3621";"1832";"1789";"102,4";"2663";"958";"73,54";3501202
"Álvares Machado";"2016";"23639";"11644";"11995";"97,07";"21474";"2165";"90,84";3501301
"Álvares Machado";"2017";"23677";"11654";"12023";"96,93";"21536";"2141";"90,96";3501301
"Álvares Machado";"2018";"23714";"11664";"12050";"96,8";"21597";"2117";"91,07";3501301
"Álvares Machado";"2019";"23751";"11674";"12077";"96,66";"21658";"2093";"91,19";3501301
"Álvares Machado";"2020";"23789";"11684";"12105";"96,52";"21720";"2069";"91,3";3501301
"Álvaro de Carvalho";"2016";"4883";"3067";"1816";"168,89";"3216";"1667";"65,86";3501400
"Álvaro de Carvalho";"2017";"4922";"3085";"1837";"167,94";"3261";"1661";"66,25";3501400
"Álvaro de Carvalho";"2018";"4962";"3104";"1858";"167,06";"3307";"1655";"66,65";3501400
"Álvaro de Carvalho";"2019";"5003";"3123";"1880";"166,12";"3353";"1650";"67,02";3501400
"Álvaro de Carvalho";"2020";"5044";"3142";"1902";"165,19";"3400";"1644";"67,41";3501400
"Alvinlândia";"2016";"3109";"1533";"1576";"97,27";"2841";"268";"91,38";3501509
"Alvinlândia";"2017";"3126";"1541";"1585";"97,22";"2864";"262";"91,62";3501509
"Alvinlândia";"2018";"3142";"1549";"1593";"97,24";"2885";"257";"91,82";3501509
"Alvinlândia";"2019";"3160";"1558";"1602";"97,25";"2908";"252";"92,03";3501509
"Alvinlândia";"2020";"3176";"1566";"1610";"97,27";"2929";"247";"92,22";3501509
"Americana";"2016";"225183";"110185";"114998";"95,81";"224131";"1052";"99,53";3501608
"Americana";"2017";"227223";"111166";"116057";"95,79";"226162";"1061";"99,53";3501608
"Americana";"2018";"229283";"112157";"117126";"95,76";"228212";"1071";"99,53";3501608
"Americana";"2019";"231361";"113156";"118205";"95,73";"230280";"1081";"99,53";3501608
"Americana";"2020";"233458";"114164";"119294";"95,7";"232367";"1091";"99,53";3501608
"Américo Brasiliense";"2016";"38030";"19045";"18985";"100,32";"37742";"288";"99,24";3501707
"Américo Brasiliense";"2017";"38572";"19305";"19267";"100,2";"38280";"292";"99,24";3501707
"Américo Brasiliense";"2018";"39121";"19568";"19553";"100,08";"38825";"296";"99,24";3501707
"Américo Brasiliense";"2019";"39678";"19835";"19843";"99,96";"39378";"300";"99,24";3501707
"Américo Brasiliense";"2020";"40243";"20106";"20137";"99,85";"39938";"305";"99,24";3501707
"Américo de Campos";"2016";"5732";"2868";"2864";"100,14";"4947";"785";"86,3";3501806
"Américo de Campos";"2017";"5733";"2867";"2866";"100,03";"4968";"765";"86,66";3501806
"Américo de Campos";"2018";"5734";"2867";"2867";"100";"4988";"746";"86,99";3501806
"Américo de Campos";"2019";"5735";"2866";"2869";"99,9";"5007";"728";"87,31";3501806
"Américo de Campos";"2020";"5736";"2865";"2871";"99,79";"5025";"711";"87,6";3501806
"Amparo";"2016";"68260";"33559";"34701";"96,71";"56082";"12178";"82,16";3501905
"Amparo";"2017";"68602";"33715";"34887";"96,64";"56723";"11879";"82,68";3501905
"Amparo";"2018";"68945";"33872";"35073";"96,58";"57360";"11585";"83,2";3501905
"Amparo";"2019";"69291";"34030";"35261";"96,51";"57992";"11299";"83,69";3501905
"Amparo";"2020";"69639";"34189";"35450";"96,44";"58620";"11019";"84,18";3501905
"Analândia";"2016";"4643";"2375";"2268";"104,72";"3815";"828";"82,17";3502002
"Analândia";"2017";"4694";"2400";"2294";"104,62";"3877";"817";"82,59";3502002
"Analândia";"2018";"4746";"2425";"2321";"104,48";"3940";"806";"83,02";3502002
"Analândia";"2019";"4798";"2450";"2348";"104,34";"4003";"795";"83,43";3502002
"Analândia";"2020";"4850";"2475";"2375";"104,21";"4065";"785";"83,81";3502002
"Andradina";"2016";"55831";"27362";"28469";"96,11";"52446";"3385";"93,94";3502101
"Andradina";"2017";"55886";"27382";"28504";"96,06";"52550";"3336";"94,03";3502101
"Andradina";"2018";"55943";"27403";"28540";"96,02";"52654";"3289";"94,12";3502101
"Andradina";"2019";"55998";"27423";"28575";"95,97";"52755";"3243";"94,21";3502101
"Andradina";"2020";"56054";"27443";"28611";"95,92";"52856";"3198";"94,29";3502101
"Angatuba";"2016";"23586";"11879";"11707";"101,47";"17372";"6214";"73,65";3502200
"Angatuba";"2017";"23811";"11983";"11828";"101,31";"17608";"6203";"73,95";3502200
"Angatuba";"2018";"24038";"12088";"11950";"101,15";"17846";"6192";"74,24";3502200
"Angatuba";"2019";"24269";"12195";"12074";"101";"18089";"6180";"74,54";3502200
"Angatuba";"2020";"24501";"12302";"12199";"100,84";"18333";"6168";"74,83";3502200
"Anhembi";"2016";"6269";"3204";"3065";"104,54";"4860";"1409";"77,52";3502309
"Anhembi";"2017";"6367";"3251";"3116";"104,33";"4956";"1411";"77,84";3502309
"Anhembi";"2018";"6467";"3299";"3168";"104,14";"5054";"1413";"78,15";3502309
"Anhembi";"2019";"6568";"3348";"3220";"103,98";"5154";"1414";"78,47";3502309
"Anhembi";"2020";"6672";"3398";"3274";"103,79";"5256";"1416";"78,78";3502309
"Anhumas";"2016";"3877";"1930";"1947";"99,13";"3320";"557";"85,63";3502408
"Anhumas";"2017";"3898";"1940";"1958";"99,08";"3360";"538";"86,2";3502408
"Anhumas";"2018";"3919";"1950";"1969";"99,04";"3399";"520";"86,73";3502408
"Anhumas";"2019";"3942";"1961";"1981";"98,99";"3439";"503";"87,24";3502408
"Anhumas";"2020";"3963";"1971";"1992";"98,95";"3477";"486";"87,74";3502408
"Aparecida";"2016";"35432";"17070";"18362";"92,96";"34917";"515";"98,55";3502507
"Aparecida";"2017";"35501";"17099";"18402";"92,92";"34985";"516";"98,55";3502507
"Aparecida";"2018";"35570";"17128";"18442";"92,87";"35053";"517";"98,55";3502507
"Aparecida";"2019";"35640";"17158";"18482";"92,84";"35122";"518";"98,55";3502507
"Aparecida";"2020";"35709";"17187";"18522";"92,79";"35190";"519";"98,55";3502507
"Aparecida d'Oeste";"2016";"4253";"2066";"2187";"94,47";"3622";"631";"85,16";3502606
"Aparecida d'Oeste";"2017";"4222";"2049";"2173";"94,29";"3615";"607";"85,62";3502606
"Aparecida d'Oeste";"2018";"4192";"2033";"2159";"94,16";"3607";"585";"86,04";3502606
"Aparecida d'Oeste";"2019";"4162";"2017";"2145";"94,03";"3599";"563";"86,47";3502606
"Aparecida d'Oeste";"2020";"4132";"2001";"2131";"93,9";"3589";"543";"86,86";3502606
"Apiaí";"2016";"24695";"12321";"12374";"99,57";"19228";"5467";"77,86";3502705
"Apiaí";"2017";"24688";"12315";"12373";"99,53";"19430";"5258";"78,7";3502705
"Apiaí";"2018";"24681";"12310";"12371";"99,51";"19625";"5056";"79,51";3502705
"Apiaí";"2019";"24674";"12304";"12370";"99,47";"19813";"4861";"80,3";3502705
"Apiaí";"2020";"24666";"12298";"12368";"99,43";"19995";"4671";"81,06";3502705
"Aramina";"2016";"5371";"2685";"2686";"99,96";"5127";"244";"95,46";3503000
"Aramina";"2017";"5402";"2699";"2703";"99,85";"5169";"233";"95,69";3503000
"Aramina";"2018";"5433";"2713";"2720";"99,74";"5211";"222";"95,91";3503000
"Aramina";"2019";"5465";"2727";"2738";"99,6";"5253";"212";"96,12";3503000
"Aramina";"2020";"5496";"2741";"2755";"99,49";"5293";"203";"96,31";3503000
"Arandu";"2016";"6144";"3092";"3052";"101,31";"4908";"1236";"79,88";3503109
"Arandu";"2017";"6149";"3094";"3055";"101,28";"4954";"1195";"80,57";3503109
"Arandu";"2018";"6154";"3095";"3059";"101,18";"4999";"1155";"81,23";3503109
"Arandu";"2019";"6159";"3097";"3062";"101,14";"5043";"1116";"81,88";3503109
"Arandu";"2020";"6165";"3099";"3066";"101,08";"5087";"1078";"82,51";3503109
"Arapeí";"2016";"2471";"1240";"1231";"100,73";"1896";"575";"76,73";3503158
"Arapeí";"2017";"2472";"1239";"1233";"100,49";"1903";"569";"76,98";3503158
"Arapeí";"2018";"2471";"1237";"1234";"100,24";"1908";"563";"77,22";3503158
"Arapeí";"2019";"2472";"1236";"1236";"100";"1914";"558";"77,43";3503158
"Arapeí";"2020";"2471";"1234";"1237";"99,76";"1920";"551";"77,7";3503158
"Araraquara";"2016";"221205";"106715";"114490";"93,21";"214916";"6289";"97,16";3503208
"Araraquara";"2017";"222791";"107482";"115309";"93,21";"216457";"6334";"97,16";3503208
"Araraquara";"2018";"224389";"108255";"116134";"93,22";"218010";"6379";"97,16";3503208
"Araraquara";"2019";"225997";"109032";"116965";"93,22";"219572";"6425";"97,16";3503208
"Araraquara";"2020";"227618";"109815";"117803";"93,22";"221147";"6471";"97,16";3503208
"Araras";"2016";"126338";"62182";"64156";"96,92";"119997";"6341";"94,98";3503307
"Araras";"2017";"127501";"62723";"64778";"96,83";"121175";"6326";"95,04";3503307
"Araras";"2018";"128676";"63269";"65407";"96,73";"122364";"6312";"95,09";3503307
"Araras";"2019";"129861";"63820";"66041";"96,64";"123563";"6298";"95,15";3503307
"Araras";"2020";"131057";"64375";"66682";"96,54";"124772";"6285";"95,2";3503307
"Araçariguama";"2016";"19493";"9884";"9609";"102,86";"19493";"-";"100";3502754
"Araçariguama";"2017";"19855";"10061";"9794";"102,73";"19855";"-";"100";3502754
"Araçariguama";"2018";"20223";"10241";"9982";"102,59";"20223";"-";"100";3502754
"Araçariguama";"2019";"20598";"10424";"10174";"102,46";"20598";"-";"100";3502754
"Araçariguama";"2020";"20980";"10611";"10369";"102,33";"20980";"-";"100";3502754
"Araçatuba";"2016";"187313";"89919";"97394";"92,32";"183700";"3613";"98,07";3502804
"Araçatuba";"2017";"188097";"90277";"97820";"92,29";"184469";"3628";"98,07";3502804
"Araçatuba";"2018";"188884";"90636";"98248";"92,25";"185241";"3643";"98,07";3502804
"Araçatuba";"2019";"189674";"90997";"98677";"92,22";"186016";"3658";"98,07";3502804
"Araçatuba";"2020";"190469";"91360";"99109";"92,18";"186796";"3673";"98,07";3502804
"Araçoiaba da Serra";"2016";"30388";"15069";"15319";"98,37";"20887";"9501";"68,73";3502903
"Araçoiaba da Serra";"2017";"30876";"15299";"15577";"98,22";"21223";"9653";"68,74";3502903
"Araçoiaba da Serra";"2018";"31373";"15533";"15840";"98,06";"21564";"9809";"68,73";3502903
"Araçoiaba da Serra";"2019";"31878";"15771";"16107";"97,91";"21911";"9967";"68,73";3502903
"Araçoiaba da Serra";"2020";"32390";"16012";"16378";"97,77";"22263";"10127";"68,73";3502903
"Arco-Íris";"2016";"1849";"926";"923";"100,33";"1134";"715";"61,33";3503356
"Arco-Íris";"2017";"1841";"921";"920";"100,11";"1143";"698";"62,09";3503356
"Arco-Íris";"2018";"1832";"916";"916";"100";"1150";"682";"62,77";3503356
"Arco-Íris";"2019";"1824";"911";"913";"99,78";"1157";"667";"63,43";3503356
"Arco-Íris";"2020";"1816";"906";"910";"99,56";"1165";"651";"64,15";3503356
"Arealva";"2016";"8060";"4072";"3988";"102,11";"6608";"1452";"81,99";3503406
"Arealva";"2017";"8094";"4084";"4010";"101,85";"6675";"1419";"82,47";3503406
"Arealva";"2018";"8127";"4096";"4031";"101,61";"6741";"1386";"82,95";3503406
"Arealva";"2019";"8162";"4109";"4053";"101,38";"6809";"1353";"83,42";3503406
"Arealva";"2020";"8196";"4121";"4075";"101,13";"6875";"1321";"83,88";3503406
"Areias";"2016";"3772";"1867";"1905";"98,01";"2529";"1243";"67,05";3503505
"Areias";"2017";"3789";"1875";"1914";"97,96";"2540";"1249";"67,04";3503505
"Areias";"2018";"3807";"1884";"1923";"97,97";"2552";"1255";"67,03";3503505
"Areias";"2019";"3825";"1892";"1933";"97,88";"2564";"1261";"67,03";3503505
"Areias";"2020";"3843";"1901";"1942";"97,89";"2577";"1266";"67,06";3503505
"Areiópolis";"2016";"10719";"5500";"5219";"105,38";"9791";"928";"91,34";3503604
"Areiópolis";"2017";"10753";"5514";"5239";"105,25";"9861";"892";"91,7";3503604
"Areiópolis";"2018";"10788";"5529";"5259";"105,13";"9929";"859";"92,04";3503604
"Areiópolis";"2019";"10822";"5543";"5279";"105";"9996";"826";"92,37";3503604
"Areiópolis";"2020";"10857";"5558";"5299";"104,89";"10062";"795";"92,68";3503604
"Ariranha";"2016";"9025";"4580";"4445";"103,04";"8547";"478";"94,7";3503703
"Ariranha";"2017";"9098";"4613";"4485";"102,85";"8616";"482";"94,7";3503703
"Ariranha";"2018";"9171";"4646";"4525";"102,67";"8685";"486";"94,7";3503703
"Ariranha";"2019";"9245";"4680";"4565";"102,52";"8755";"490";"94,7";3503703
"Ariranha";"2020";"9320";"4714";"4606";"102,34";"8826";"494";"94,7";3503703
"Artur Nogueira";"2016";"49620";"24693";"24927";"99,06";"44926";"4694";"90,54";3503802
"Artur Nogueira";"2017";"50351";"25042";"25309";"98,95";"45588";"4763";"90,54";3503802
"Artur Nogueira";"2018";"51092";"25396";"25696";"98,83";"46259";"4833";"90,54";3503802
"Artur Nogueira";"2019";"51846";"25756";"26090";"98,72";"46942";"4904";"90,54";3503802
"Artur Nogueira";"2020";"52609";"26120";"26489";"98,61";"47632";"4977";"90,54";3503802
"Arujá";"2016";"83849";"41346";"42503";"97,28";"80655";"3194";"96,19";3503901
"Arujá";"2017";"85286";"42053";"43233";"97,27";"82062";"3224";"96,22";3503901
"Arujá";"2018";"86746";"42771";"43975";"97,26";"83492";"3254";"96,25";3503901
"Arujá";"2019";"88232";"43502";"44730";"97,25";"84948";"3284";"96,28";3503901
"Arujá";"2020";"89744";"44246";"45498";"97,25";"86429";"3315";"96,31";3503901
"Aspásia";"2016";"1782";"892";"890";"100,22";"1298";"484";"72,84";3503950
"Aspásia";"2017";"1777";"889";"888";"100,11";"1304";"473";"73,38";3503950
"Aspásia";"2018";"1774";"887";"887";"100";"1311";"463";"73,9";3503950
"Aspásia";"2019";"1769";"884";"885";"99,89";"1316";"453";"74,39";3503950
"Aspásia";"2020";"1765";"882";"883";"99,89";"1322";"443";"74,9";3503950
"Assis";"2016";"99001";"48192";"50809";"94,85";"94680";"4321";"95,64";3504008
"Assis";"2017";"99591";"48483";"51108";"94,86";"95244";"4347";"95,64";3504008
"Assis";"2018";"100184";"48775";"51409";"94,88";"95811";"4373";"95,64";3504008
"Assis";"2019";"100781";"49069";"51712";"94,89";"96382";"4399";"95,64";3504008
"Assis";"2020";"101381";"49365";"52016";"94,9";"96956";"4425";"95,64";3504008
"Atibaia";"2016";"134652";"66064";"68588";"96,32";"124870";"9782";"92,74";3504107
"Atibaia";"2017";"135875";"66650";"69225";"96,28";"126339";"9536";"92,98";3504107
"Atibaia";"2018";"137107";"67240";"69867";"96,24";"127809";"9298";"93,22";3504107
"Atibaia";"2019";"138351";"67836";"70515";"96,2";"129281";"9070";"93,44";3504107
"Atibaia";"2020";"139606";"68437";"71169";"96,16";"130756";"8850";"93,66";3504107
"Auriflama";"2016";"14387";"7159";"7228";"99,05";"13324";"1063";"92,61";3504206
"Auriflama";"2017";"14408";"7164";"7244";"98,9";"13374";"1034";"92,82";3504206
"Auriflama";"2018";"14429";"7170";"7259";"98,77";"13422";"1007";"93,02";3504206
"Auriflama";"2019";"14450";"7175";"7275";"98,63";"13470";"980";"93,22";3504206
"Auriflama";"2020";"14471";"7181";"7290";"98,5";"13517";"954";"93,41";3504206
"Avaí";"2016";"5158";"2589";"2569";"100,78";"3464";"1694";"67,16";3504305
"Avaí";"2017";"5191";"2603";"2588";"100,58";"3486";"1705";"67,15";3504305
"Avaí";"2018";"5223";"2616";"2607";"100,35";"3507";"1716";"67,15";3504305
"Avaí";"2019";"5255";"2629";"2626";"100,11";"3529";"1726";"67,16";3504305
"Avaí";"2020";"5288";"2643";"2645";"99,92";"3551";"1737";"67,15";3504305
"Avanhandava";"2016";"11787";"6475";"5312";"121,89";"9966";"1821";"84,55";3504404
"Avanhandava";"2017";"11867";"6515";"5352";"121,73";"10034";"1833";"84,55";3504404
"Avanhandava";"2018";"11949";"6555";"5394";"121,52";"10103";"1846";"84,55";3504404
"Avanhandava";"2019";"12030";"6595";"5435";"121,34";"10172";"1858";"84,56";3504404
"Avanhandava";"2020";"12114";"6637";"5477";"121,18";"10243";"1871";"84,56";3504404
"Avaré";"2016";"85810";"42503";"43307";"98,14";"82585";"3225";"96,24";3504503
"Avaré";"2017";"86238";"42709";"43529";"98,12";"83064";"3174";"96,32";3504503
"Avaré";"2018";"86669";"42917";"43752";"98,09";"83545";"3124";"96,4";3504503
"Avaré";"2019";"87102";"43125";"43977";"98,06";"84026";"3076";"96,47";3504503
"Avaré";"2020";"87538";"43336";"44202";"98,04";"84509";"3029";"96,54";3504503
"Bady Bassitt";"2016";"15750";"7821";"7929";"98,64";"14781";"969";"93,85";3504602
"Bady Bassitt";"2017";"15893";"7892";"8001";"98,64";"14918";"975";"93,87";3504602
"Bady Bassitt";"2018";"16037";"7964";"8073";"98,65";"15056";"981";"93,88";3504602
"Bady Bassitt";"2019";"16182";"8036";"8146";"98,65";"15194";"988";"93,89";3504602
"Bady Bassitt";"2020";"16329";"8109";"8220";"98,65";"15333";"996";"93,9";3504602
"Balbinos";"2016";"3695";"2976";"719";"413,91";"1189";"2506";"32,18";3504701
"Balbinos";"2017";"3698";"2977";"721";"412,9";"1190";"2508";"32,18";3504701
"Balbinos";"2018";"3699";"2977";"722";"412,33";"1190";"2509";"32,17";3504701
"Balbinos";"2019";"3702";"2978";"724";"411,33";"1191";"2511";"32,17";3504701
"Balbinos";"2020";"3704";"2978";"726";"410,19";"1191";"2513";"32,15";3504701
"Bálsamo";"2016";"8397";"4096";"4301";"95,23";"7793";"604";"92,81";3504800
"Bálsamo";"2017";"8429";"4110";"4319";"95,16";"7833";"596";"92,93";3504800
"Bálsamo";"2018";"8460";"4123";"4337";"95,07";"7872";"588";"93,05";3504800
"Bálsamo";"2019";"8493";"4137";"4356";"94,97";"7911";"582";"93,15";3504800
"Bálsamo";"2020";"8524";"4150";"4374";"94,88";"7948";"576";"93,24";3504800
"Bananal";"2016";"10468";"5164";"5304";"97,36";"8659";"1809";"82,72";3504909
"Bananal";"2017";"10514";"5186";"5328";"97,33";"8744";"1770";"83,17";3504909
"Bananal";"2018";"10560";"5208";"5352";"97,31";"8828";"1732";"83,6";3504909
"Bananal";"2019";"10605";"5229";"5376";"97,27";"8911";"1694";"84,03";3504909
"Bananal";"2020";"10651";"5251";"5400";"97,24";"8994";"1657";"84,44";3504909
"Barão de Antonina";"2016";"3274";"1661";"1613";"102,98";"2056";"1218";"62,8";3505005
"Barão de Antonina";"2017";"3301";"1673";"1628";"102,76";"2081";"1220";"63,04";3505005
"Barão de Antonina";"2018";"3328";"1685";"1643";"102,56";"2106";"1222";"63,28";3505005
"Barão de Antonina";"2019";"3356";"1698";"1658";"102,41";"2131";"1225";"63,5";3505005
"Barão de Antonina";"2020";"3383";"1710";"1673";"102,21";"2156";"1227";"63,73";3505005
"Barbosa";"2016";"7002";"3514";"3488";"100,75";"5962";"1040";"85,15";3505104
"Barbosa";"2017";"7072";"3548";"3524";"100,68";"6029";"1043";"85,25";3505104
"Barbosa";"2018";"7142";"3582";"3560";"100,62";"6095";"1047";"85,34";3505104
"Barbosa";"2019";"7212";"3616";"3596";"100,56";"6162";"1050";"85,44";3505104
"Barbosa";"2020";"7284";"3651";"3633";"100,5";"6230";"1054";"85,53";3505104
"Bariri";"2016";"33093";"16522";"16571";"99,7";"31728";"1365";"95,88";3505203
"Bariri";"2017";"33315";"16626";"16689";"99,62";"31986";"1329";"96,01";3505203
"Bariri";"2018";"33540";"16732";"16808";"99,55";"32246";"1294";"96,14";3505203
"Bariri";"2019";"33765";"16837";"16928";"99,46";"32503";"1262";"96,26";3505203
"Bariri";"2020";"33993";"16944";"17049";"99,38";"32762";"1231";"96,38";3505203
"Barra Bonita";"2016";"35029";"17100";"17929";"95,38";"34355";"674";"98,08";3505302
"Barra Bonita";"2017";"35001";"17078";"17923";"95,29";"34335";"666";"98,1";3505302
"Barra Bonita";"2018";"34971";"17055";"17916";"95,19";"34312";"659";"98,12";3505302
"Barra Bonita";"2019";"34943";"17033";"17910";"95,1";"34291";"652";"98,13";3505302
"Barra Bonita";"2020";"34914";"17011";"17903";"95,02";"34268";"646";"98,15";3505302
"Barra do Chapéu";"2016";"5409";"2835";"2574";"110,14";"1593";"3816";"29,45";3505351
"Barra do Chapéu";"2017";"5439";"2848";"2591";"109,92";"1601";"3838";"29,44";3505351
"Barra do Chapéu";"2018";"5470";"2861";"2609";"109,66";"1611";"3859";"29,45";3505351
"Barra do Chapéu";"2019";"5499";"2873";"2626";"109,41";"1619";"3880";"29,44";3505351
"Barra do Chapéu";"2020";"5530";"2886";"2644";"109,15";"1628";"3902";"29,44";3505351
"Barra do Turvo";"2016";"7665";"3981";"3684";"108,06";"3408";"4257";"44,46";3505401
"Barra do Turvo";"2017";"7670";"3978";"3692";"107,75";"3453";"4217";"45,02";3505401
"Barra do Turvo";"2018";"7676";"3976";"3700";"107,46";"3499";"4177";"45,58";3505401
"Barra do Turvo";"2019";"7681";"3973";"3708";"107,15";"3545";"4136";"46,15";3505401
"Barra do Turvo";"2020";"7687";"3971";"3716";"106,86";"3591";"4096";"46,72";3505401
"Barretos";"2016";"115907";"56027";"59880";"93,57";"112376";"3531";"96,95";3505500
"Barretos";"2017";"116439";"56290";"60149";"93,58";"112892";"3547";"96,95";3505500
"Barretos";"2018";"116973";"56554";"60419";"93,6";"113410";"3563";"96,95";3505500
"Barretos";"2019";"117509";"56819";"60690";"93,62";"113929";"3580";"96,95";3505500
"Barretos";"2020";"118048";"57086";"60962";"93,64";"114452";"3596";"96,95";3505500
"Barrinha";"2016";"30829";"15459";"15370";"100,58";"30487";"342";"98,89";3505609
"Barrinha";"2017";"31199";"15638";"15561";"100,49";"30853";"346";"98,89";3505609
"Barrinha";"2018";"31574";"15820";"15754";"100,42";"31224";"350";"98,89";3505609
"Barrinha";"2019";"31954";"16004";"15950";"100,34";"31600";"354";"98,89";3505609
"Barrinha";"2020";"32338";"16190";"16148";"100,26";"31979";"359";"98,89";3505609
"Barueri";"2016";"255276";"124186";"131090";"94,73";"255276";"-";"100";3505708
"Barueri";"2017";"257525";"125282";"132243";"94,74";"257525";"-";"100";3505708
"Barueri";"2018";"259793";"126387";"133406";"94,74";"259793";"-";"100";3505708
"Barueri";"2019";"262081";"127502";"134579";"94,74";"262081";"-";"100";3505708
"Barueri";"2020";"264390";"128627";"135763";"94,74";"264390";"-";"100";3505708
"Bastos";"2016";"20267";"9918";"10349";"95,84";"17782";"2485";"87,74";3505807
"Bastos";"2017";"20276";"9918";"10358";"95,75";"17839";"2437";"87,98";3505807
"Bastos";"2018";"20284";"9917";"10367";"95,66";"17894";"2390";"88,22";3505807
"Bastos";"2019";"20293";"9917";"10376";"95,58";"17949";"2344";"88,45";3505807
"Bastos";"2020";"20301";"9916";"10385";"95,48";"18001";"2300";"88,67";3505807
"Batatais";"2016";"58821";"28861";"29960";"96,33";"52019";"6802";"88,44";3505906
"Batatais";"2017";"59167";"29026";"30141";"96,3";"52325";"6842";"88,44";3505906
"Batatais";"2018";"59517";"29193";"30324";"96,27";"52634";"6883";"88,44";3505906
"Batatais";"2019";"59868";"29360";"30508";"96,24";"52945";"6923";"88,44";3505906
"Batatais";"2020";"60222";"29529";"30693";"96,21";"53258";"6964";"88,44";3505906
"Bauru";"2016";"356769";"172853";"183916";"93,98";"350801";"5968";"98,33";3506003
"Bauru";"2017";"358619";"173752";"184867";"93,99";"352620";"5999";"98,33";3506003
"Bauru";"2018";"360478";"174654";"185824";"93,99";"354448";"6030";"98,33";3506003
"Bauru";"2019";"362348";"175562";"186786";"93,99";"356287";"6061";"98,33";3506003
"Bauru";"2020";"364225";"176473";"187752";"93,99";"358133";"6092";"98,33";3506003
"Bebedouro";"2016";"74593";"36270";"38323";"94,64";"71524";"3069";"95,89";3506102
"Bebedouro";"2017";"74483";"36209";"38274";"94,6";"71475";"3008";"95,96";3506102
"Bebedouro";"2018";"74373";"36147";"38226";"94,56";"71422";"2951";"96,03";3506102
"Bebedouro";"2019";"74264";"36086";"38178";"94,52";"71366";"2898";"96,1";3506102
"Bebedouro";"2020";"74155";"36025";"38130";"94,48";"71307";"2848";"96,16";3506102
"Bento de Abreu";"2016";"2840";"1440";"1400";"102,86";"2680";"160";"94,37";3506201
"Bento de Abreu";"2017";"2866";"1452";"1414";"102,69";"2715";"151";"94,73";3506201
"Bento de Abreu";"2018";"2892";"1464";"1428";"102,52";"2748";"144";"95,02";3506201
"Bento de Abreu";"2019";"2919";"1477";"1442";"102,43";"2783";"136";"95,34";3506201
"Bento de Abreu";"2020";"2945";"1489";"1456";"102,27";"2815";"130";"95,59";3506201
"Bernardino de Campos";"2016";"10773";"5239";"5534";"94,67";"9785";"988";"90,83";3506300
"Bernardino de Campos";"2017";"10777";"5240";"5537";"94,64";"9807";"970";"91";3506300
"Bernardino de Campos";"2018";"10780";"5241";"5539";"94,62";"9828";"952";"91,17";3506300
"Bernardino de Campos";"2019";"10784";"5242";"5542";"94,59";"9850";"934";"91,34";3506300
"Bernardino de Campos";"2020";"10787";"5243";"5544";"94,57";"9869";"918";"91,49";3506300
"Bertioga";"2016";"57109";"28422";"28687";"99,08";"56441";"668";"98,83";3506359
"Bertioga";"2017";"58595";"29141";"29454";"98,94";"57946";"649";"98,89";3506359
"Bertioga";"2018";"60120";"29878";"30242";"98,8";"59490";"630";"98,95";3506359
"Bertioga";"2019";"61684";"30633";"31051";"98,65";"61072";"612";"99,01";3506359
"Bertioga";"2020";"63290";"31408";"31882";"98,51";"62695";"595";"99,06";3506359
"Bilac";"2016";"7537";"3720";"3817";"97,46";"7048";"489";"93,51";3506409
"Bilac";"2017";"7606";"3752";"3854";"97,35";"7129";"477";"93,73";3506409
"Bilac";"2018";"7676";"3784";"3892";"97,23";"7211";"465";"93,94";3506409
"Bilac";"2019";"7745";"3816";"3929";"97,12";"7291";"454";"94,14";3506409
"Bilac";"2020";"7816";"3849";"3967";"97,03";"7373";"443";"94,33";3506409
"Birigui";"2016";"116637";"56766";"59871";"94,81";"113416";"3221";"97,24";3506508
"Birigui";"2017";"117793";"57308";"60485";"94,75";"114578";"3215";"97,27";3506508
"Birigui";"2018";"118960";"57855";"61105";"94,68";"115750";"3210";"97,3";3506508
"Birigui";"2019";"120138";"58407";"61731";"94,62";"116931";"3207";"97,33";3506508
"Birigui";"2020";"121329";"58965";"62364";"94,55";"118125";"3204";"97,36";3506508
"Biritiba Mirim";"2016";"30822";"15497";"15325";"101,12";"26719";"4103";"86,69";3506607
"Biritiba Mirim";"2017";"31195";"15677";"15518";"101,02";"27085";"4110";"86,82";3506607
"Biritiba Mirim";"2018";"31571";"15858";"15713";"100,92";"27455";"4116";"86,96";3506607
"Biritiba Mirim";"2019";"31952";"16041";"15911";"100,82";"27830";"4122";"87,1";3506607
"Biritiba Mirim";"2020";"32338";"16227";"16111";"100,72";"28210";"4128";"87,23";3506607
"Boa Esperança do Sul";"2016";"14211";"7123";"7088";"100,49";"12930";"1281";"90,99";3506706
"Boa Esperança do Sul";"2017";"14303";"7163";"7140";"100,32";"13049";"1254";"91,23";3506706
"Boa Esperança do Sul";"2018";"14396";"7203";"7193";"100,14";"13168";"1228";"91,47";3506706
"Boa Esperança do Sul";"2019";"14489";"7243";"7246";"99,96";"13286";"1203";"91,7";3506706
"Boa Esperança do Sul";"2020";"14582";"7283";"7299";"99,78";"13403";"1179";"91,91";3506706
"Bocaina";"2016";"11646";"5790";"5856";"98,87";"10827";"819";"92,97";3506805
"Bocaina";"2017";"11767";"5847";"5920";"98,77";"10954";"813";"93,09";3506805
"Bocaina";"2018";"11888";"5905";"5983";"98,7";"11082";"806";"93,22";3506805
"Bocaina";"2019";"12011";"5963";"6048";"98,59";"11211";"800";"93,34";3506805
"Bocaina";"2020";"12135";"6022";"6113";"98,51";"11341";"794";"93,46";3506805
"Bofete";"2016";"10512";"5313";"5199";"102,19";"6702";"3810";"63,76";3506904
"Bofete";"2017";"10651";"5376";"5275";"101,91";"6791";"3860";"63,76";3506904
"Bofete";"2018";"10790";"5439";"5351";"101,64";"6879";"3911";"63,75";3506904
"Bofete";"2019";"10932";"5503";"5429";"101,36";"6970";"3962";"63,76";3506904
"Bofete";"2020";"11076";"5568";"5508";"101,09";"7062";"4014";"63,76";3506904
"Boituva";"2016";"54017";"27091";"26926";"100,61";"50813";"3204";"94,07";3507001
"Boituva";"2017";"54817";"27477";"27340";"100,5";"51565";"3252";"94,07";3507001
"Boituva";"2018";"55630";"27869";"27761";"100,39";"52330";"3300";"94,07";3507001
"Boituva";"2019";"56455";"28267";"28188";"100,28";"53106";"3349";"94,07";3507001
"Boituva";"2020";"57292";"28670";"28622";"100,17";"53893";"3399";"94,07";3507001
"Bom Jesus dos Perdões";"2016";"22541";"11287";"11254";"100,29";"20288";"2253";"90";3507100
"Bom Jesus dos Perdões";"2017";"22966";"11491";"11475";"100,14";"20734";"2232";"90,28";3507100
"Bom Jesus dos Perdões";"2018";"23399";"11699";"11700";"99,99";"21187";"2212";"90,55";3507100
"Bom Jesus dos Perdões";"2019";"23841";"11911";"11930";"99,84";"21649";"2192";"90,81";3507100
"Bom Jesus dos Perdões";"2020";"24291";"12127";"12164";"99,7";"22118";"2173";"91,05";3507100
"Bom Sucesso de Itararé";"2016";"3734";"1888";"1846";"102,28";"2695";"1039";"72,17";3507159
"Bom Sucesso de Itararé";"2017";"3766";"1902";"1864";"102,04";"2743";"1023";"72,84";3507159
"Bom Sucesso de Itararé";"2018";"3797";"1916";"1881";"101,86";"2790";"1007";"73,48";3507159
"Bom Sucesso de Itararé";"2019";"3829";"1930";"1899";"101,63";"2838";"991";"74,12";3507159
"Bom Sucesso de Itararé";"2020";"3861";"1944";"1917";"101,41";"2885";"976";"74,72";3507159
"Borá";"2016";"809";"423";"386";"109,59";"630";"179";"77,87";3507209
"Borá";"2017";"810";"423";"387";"109,3";"631";"179";"77,9";3507209
"Borá";"2018";"810";"422";"388";"108,76";"631";"179";"77,9";3507209
"Borá";"2019";"811";"422";"389";"108,48";"632";"179";"77,93";3507209
"Borá";"2020";"812";"422";"390";"108,21";"632";"180";"77,83";3507209
"Boracéia";"2016";"4568";"2324";"2244";"103,57";"4140";"428";"90,63";3507308
"Boracéia";"2017";"4615";"2347";"2268";"103,48";"4190";"425";"90,79";3507308
"Boracéia";"2018";"4662";"2370";"2292";"103,4";"4240";"422";"90,95";3507308
"Boracéia";"2019";"4710";"2393";"2317";"103,28";"4290";"420";"91,08";3507308
"Boracéia";"2020";"4759";"2417";"2342";"103,2";"4342";"417";"91,24";3507308
"Borborema";"2016";"15045";"7584";"7461";"101,65";"13961";"1084";"92,79";3507407
"Borborema";"2017";"15114";"7614";"7500";"101,52";"14077";"1037";"93,14";3507407
"Borborema";"2018";"15183";"7645";"7538";"101,42";"14188";"995";"93,45";3507407
"Borborema";"2019";"15253";"7676";"7577";"101,31";"14298";"955";"93,74";3507407
"Borborema";"2020";"15323";"7707";"7616";"101,19";"14405";"918";"94,01";3507407
"Borebi";"2016";"2470";"1223";"1247";"98,08";"2252";"218";"91,17";3507456
"Borebi";"2017";"2497";"1235";"1262";"97,86";"2290";"207";"91,71";3507456
"Borebi";"2018";"2524";"1247";"1277";"97,65";"2327";"197";"92,19";3507456
"Borebi";"2019";"2552";"1260";"1292";"97,52";"2364";"188";"92,63";3507456
"Borebi";"2020";"2579";"1272";"1307";"97,32";"2400";"179";"93,06";3507456
"Botucatu";"2016";"136091";"66079";"70012";"94,38";"131367";"4724";"96,53";3507506
"Botucatu";"2017";"137334";"66695";"70639";"94,42";"132606";"4728";"96,56";3507506
"Botucatu";"2018";"138590";"67317";"71273";"94,45";"133859";"4731";"96,59";3507506
"Botucatu";"2019";"139856";"67945";"71911";"94,48";"135121";"4735";"96,61";3507506
"Botucatu";"2020";"141135";"68579";"72556";"94,52";"136396";"4739";"96,64";3507506
"Bragança Paulista";"2016";"157759";"77395";"80364";"96,31";"154418";"3341";"97,88";3507605
"Bragança Paulista";"2017";"159292";"78140";"81152";"96,29";"156035";"3257";"97,96";3507605
"Bragança Paulista";"2018";"160840";"78892";"81948";"96,27";"157648";"3192";"98,02";3507605
"Bragança Paulista";"2019";"162402";"79651";"82751";"96,25";"159258";"3144";"98,06";3507605
"Bragança Paulista";"2020";"163980";"80417";"83563";"96,24";"160871";"3109";"98,1";3507605
"Braúna";"2016";"5353";"2700";"2653";"101,77";"4872";"481";"91,01";3507704
"Braúna";"2017";"5402";"2721";"2681";"101,49";"4943";"459";"91,5";3507704
"Braúna";"2018";"5452";"2743";"2709";"101,26";"5013";"439";"91,95";3507704
"Braúna";"2019";"5501";"2764";"2737";"100,99";"5081";"420";"92,37";3507704
"Braúna";"2020";"5552";"2786";"2766";"100,72";"5150";"402";"92,76";3507704
"Brejo Alegre";"2016";"2695";"1378";"1317";"104,63";"2276";"419";"84,45";3507753
"Brejo Alegre";"2017";"2713";"1385";"1328";"104,29";"2301";"412";"84,81";3507753
"Brejo Alegre";"2018";"2732";"1393";"1339";"104,03";"2327";"405";"85,18";3507753
"Brejo Alegre";"2019";"2749";"1400";"1349";"103,78";"2352";"397";"85,56";3507753
"Brejo Alegre";"2020";"2768";"1408";"1360";"103,53";"2378";"390";"85,91";3507753
"Brodowski";"2016";"22927";"11314";"11613";"97,43";"22560";"367";"98,4";3507803
"Brodowski";"2017";"23177";"11430";"11747";"97,3";"22830";"347";"98,5";3507803
"Brodowski";"2018";"23430";"11547";"11883";"97,17";"23101";"329";"98,6";3507803
"Brodowski";"2019";"23684";"11665";"12019";"97,05";"23372";"312";"98,68";3507803
"Brodowski";"2020";"23943";"11785";"12158";"96,93";"23647";"296";"98,76";3507803
"Brotas";"2016";"23003";"11407";"11596";"98,37";"19930";"3073";"86,64";3507902
"Brotas";"2017";"23212";"11509";"11703";"98,34";"20129";"3083";"86,72";3507902
"Brotas";"2018";"23423";"11612";"11811";"98,32";"20329";"3094";"86,79";3507902
"Brotas";"2019";"23635";"11715";"11920";"98,28";"20531";"3104";"86,87";3507902
"Brotas";"2020";"23850";"11820";"12030";"98,25";"20735";"3115";"86,94";3507902
"Buri";"2016";"19181";"9761";"9420";"103,62";"15833";"3348";"82,55";3508009
"Buri";"2017";"19304";"9815";"9489";"103,44";"15990";"3314";"82,83";3508009
"Buri";"2018";"19428";"9869";"9559";"103,24";"16147";"3281";"83,11";3508009
"Buri";"2019";"19553";"9924";"9629";"103,06";"16304";"3249";"83,38";3508009
"Buri";"2020";"19678";"9979";"9699";"102,89";"16462";"3216";"83,66";3508009
"Buritama";"2016";"16160";"8068";"8092";"99,7";"15411";"749";"95,37";3508108
"Buritama";"2017";"16268";"8116";"8152";"99,56";"15539";"729";"95,52";3508108
"Buritama";"2018";"16377";"8165";"8212";"99,43";"15667";"710";"95,66";3508108
"Buritama";"2019";"16486";"8214";"8272";"99,3";"15795";"691";"95,81";3508108
"Buritama";"2020";"16596";"8263";"8333";"99,16";"15922";"674";"95,94";3508108
"Buritizal";"2016";"4211";"2145";"2066";"103,82";"3494";"717";"82,97";3508207
"Buritizal";"2017";"4236";"2157";"2079";"103,75";"3524";"712";"83,19";3508207
"Buritizal";"2018";"4259";"2168";"2091";"103,68";"3553";"706";"83,42";3508207
"Buritizal";"2019";"4282";"2179";"2103";"103,61";"3581";"701";"83,63";3508207
"Buritizal";"2020";"4307";"2191";"2116";"103,54";"3611";"696";"83,84";3508207
"Cabrália Paulista";"2016";"4319";"2187";"2132";"102,58";"3757";"562";"86,99";3508306
"Cabrália Paulista";"2017";"4317";"2185";"2132";"102,49";"3758";"559";"87,05";3508306
"Cabrália Paulista";"2018";"4313";"2182";"2131";"102,39";"3758";"555";"87,13";3508306
"Cabrália Paulista";"2019";"4311";"2180";"2131";"102,3";"3759";"552";"87,2";3508306
"Cabrália Paulista";"2020";"4308";"2177";"2131";"102,16";"3760";"548";"87,28";3508306
"Cabreúva";"2016";"46306";"23337";"22969";"101,6";"40695";"5611";"87,88";3508405
"Cabreúva";"2017";"47068";"23703";"23365";"101,45";"41579";"5489";"88,34";3508405
"Cabreúva";"2018";"47842";"24075";"23767";"101,3";"42472";"5370";"88,78";3508405
"Cabreúva";"2019";"48630";"24453";"24177";"101,14";"43375";"5255";"89,19";3508405
"Cabreúva";"2020";"49430";"24837";"24593";"100,99";"44288";"5142";"89,6";3508405
"Cachoeira Paulista";"2016";"31423";"15365";"16058";"95,68";"26010";"5413";"82,77";3508603
"Cachoeira Paulista";"2017";"31623";"15457";"16166";"95,61";"26232";"5391";"82,95";3508603
"Cachoeira Paulista";"2018";"31825";"15550";"16275";"95,55";"26456";"5369";"83,13";3508603
"Cachoeira Paulista";"2019";"32027";"15642";"16385";"95,47";"26681";"5346";"83,31";3508603
"Cachoeira Paulista";"2020";"32231";"15736";"16495";"95,4";"26907";"5324";"83,48";3508603
"Caconde";"2016";"18719";"9330";"9389";"99,37";"13175";"5544";"70,38";3508702
"Caconde";"2017";"18752";"9340";"9412";"99,24";"13265";"5487";"70,74";3508702
"Caconde";"2018";"18786";"9350";"9436";"99,09";"13356";"5430";"71,1";3508702
"Caconde";"2019";"18820";"9360";"9460";"98,94";"13447";"5373";"71,45";3508702
"Caconde";"2020";"18854";"9370";"9484";"98,8";"13537";"5317";"71,8";3508702
"Cafelândia";"2016";"17000";"8364";"8636";"96,85";"15111";"1889";"88,89";3508801
"Cafelândia";"2017";"17060";"8394";"8666";"96,86";"15216";"1844";"89,19";3508801
"Cafelândia";"2018";"17121";"8424";"8697";"96,86";"15321";"1800";"89,49";3508801
"Cafelândia";"2019";"17183";"8455";"8728";"96,87";"15426";"1757";"89,77";3508801
"Cafelândia";"2020";"17244";"8485";"8759";"96,87";"15529";"1715";"90,05";3508801
"Caiabu";"2016";"4095";"2101";"1994";"105,37";"3437";"658";"83,93";3508900
"Caiabu";"2017";"4098";"2102";"1996";"105,31";"3456";"642";"84,33";3508900
"Caiabu";"2018";"4099";"2102";"1997";"105,26";"3472";"627";"84,7";3508900
"Caiabu";"2019";"4102";"2103";"1999";"105,2";"3490";"612";"85,08";3508900
"Caiabu";"2020";"4103";"2103";"2000";"105,15";"3506";"597";"85,45";3508900
"Caieiras";"2016";"94994";"46500";"48494";"95,89";"93114";"1880";"98,02";3509007
"Caieiras";"2017";"96368";"47180";"49188";"95,92";"94524";"1844";"98,09";3509007
"Caieiras";"2018";"97763";"47871";"49892";"95,95";"95953";"1810";"98,15";3509007
"Caieiras";"2019";"99177";"48571";"50606";"95,98";"97399";"1778";"98,21";3509007
"Caieiras";"2020";"100612";"49282";"51330";"96,01";"98864";"1748";"98,26";3509007
"Caiuá";"2016";"5381";"2798";"2583";"108,32";"2061";"3320";"38,3";3509106
"Caiuá";"2017";"5435";"2821";"2614";"107,92";"2082";"3353";"38,31";3509106
"Caiuá";"2018";"5489";"2845";"2644";"107,6";"2102";"3387";"38,29";3509106
"Caiuá";"2019";"5543";"2868";"2675";"107,21";"2123";"3420";"38,3";3509106
"Caiuá";"2020";"5600";"2893";"2707";"106,87";"2145";"3455";"38,3";3509106
"Cajamar";"2016";"72289";"36021";"36268";"99,32";"71289";"1000";"98,62";3509205
"Cajamar";"2017";"73588";"36660";"36928";"99,27";"72617";"971";"98,68";3509205
"Cajamar";"2018";"74910";"37310";"37600";"99,23";"73962";"948";"98,73";3509205
"Cajamar";"2019";"76256";"37972";"38284";"99,19";"75328";"928";"98,78";3509205
"Cajamar";"2020";"77627";"38646";"38981";"99,14";"76714";"913";"98,82";3509205
"Cajati";"2016";"28601";"14415";"14186";"101,61";"21083";"7518";"73,71";3509254
"Cajati";"2017";"28697";"14458";"14239";"101,54";"21185";"7512";"73,82";3509254
"Cajati";"2018";"28795";"14502";"14293";"101,46";"21290";"7505";"73,94";3509254
"Cajati";"2019";"28894";"14546";"14348";"101,38";"21395";"7499";"74,05";3509254
"Cajati";"2020";"28992";"14590";"14402";"101,31";"21499";"7493";"74,15";3509254
"Cajobi";"2016";"9987";"5100";"4887";"104,36";"9433";"554";"94,45";3509304
"Cajobi";"2017";"10016";"5109";"4907";"104,12";"9474";"542";"94,59";3509304
"Cajobi";"2018";"10046";"5119";"4927";"103,9";"9515";"531";"94,71";3509304
"Cajobi";"2019";"10076";"5128";"4948";"103,64";"9555";"521";"94,83";3509304
"Cajobi";"2020";"10105";"5137";"4968";"103,4";"9594";"511";"94,94";3509304
"Cajuru";"2016";"24758";"12352";"12406";"99,56";"22089";"2669";"89,22";3509403
"Cajuru";"2017";"24981";"12458";"12523";"99,48";"22298";"2683";"89,26";3509403
"Cajuru";"2018";"25206";"12566";"12640";"99,41";"22509";"2697";"89,3";3509403
"Cajuru";"2019";"25434";"12675";"12759";"99,34";"22722";"2712";"89,34";3509403
"Cajuru";"2020";"25663";"12784";"12879";"99,26";"22937";"2726";"89,38";3509403
"Campina do Monte Alegre";"2016";"5714";"2900";"2814";"103,06";"4959";"755";"86,79";3509452
"Campina do Monte Alegre";"2017";"5738";"2907";"2831";"102,68";"5000";"738";"87,14";3509452
"Campina do Monte Alegre";"2018";"5763";"2915";"2848";"102,35";"5040";"723";"87,45";3509452
"Campina do Monte Alegre";"2019";"5788";"2922";"2866";"101,95";"5081";"707";"87,79";3509452
"Campina do Monte Alegre";"2020";"5812";"2929";"2883";"101,6";"5120";"692";"88,09";3509452
"Campinas";"2016";"1142620";"551266";"591354";"93,22";"1122972";"19648";"98,28";3509502
"Campinas";"2017";"1150753";"555215";"595538";"93,23";"1130965";"19788";"98,28";3509502
"Campinas";"2018";"1158944";"559193";"599751";"93,24";"1139015";"19929";"98,28";3509502
"Campinas";"2019";"1167192";"563198";"603994";"93,25";"1147122";"20070";"98,28";3509502
"Campinas";"2020";"1175501";"567233";"608268";"93,25";"1155288";"20213";"98,28";3509502
"Campo Limpo Paulista";"2016";"79446";"38978";"40468";"96,32";"79446";"-";"100";3509601
"Campo Limpo Paulista";"2017";"80282";"39380";"40902";"96,28";"80282";"-";"100";3509601
"Campo Limpo Paulista";"2018";"81126";"39786";"41340";"96,24";"81126";"-";"100";3509601
"Campo Limpo Paulista";"2019";"81979";"40196";"41783";"96,2";"81979";"-";"100";3509601
"Campo Limpo Paulista";"2020";"82842";"40611";"42231";"96,16";"82842";"-";"100";3509601
"Campos do Jordão";"2016";"49219";"23989";"25230";"95,08";"48912";"307";"99,38";3509700
"Campos do Jordão";"2017";"49442";"24084";"25358";"94,98";"49134";"308";"99,38";3509700
"Campos do Jordão";"2018";"49666";"24179";"25487";"94,87";"49356";"310";"99,38";3509700
"Campos do Jordão";"2019";"49892";"24275";"25617";"94,76";"49581";"311";"99,38";3509700
"Campos do Jordão";"2020";"50118";"24371";"25747";"94,66";"49805";"313";"99,38";3509700
"Campos Novos Paulista";"2016";"4705";"2413";"2292";"105,28";"3803";"902";"80,83";3509809
"Campos Novos Paulista";"2017";"4732";"2425";"2307";"105,11";"3847";"885";"81,3";3509809
"Campos Novos Paulista";"2018";"4760";"2438";"2322";"105";"3892";"868";"81,76";3509809
"Campos Novos Paulista";"2019";"4789";"2451";"2338";"104,83";"3937";"852";"82,21";3509809
"Campos Novos Paulista";"2020";"4817";"2464";"2353";"104,72";"3981";"836";"82,64";3509809
"Cananéia";"2016";"12236";"6110";"6126";"99,74";"10560";"1676";"86,3";3509908
"Cananéia";"2017";"12263";"6119";"6144";"99,59";"10599";"1664";"86,43";3509908
"Cananéia";"2018";"12289";"6127";"6162";"99,43";"10637";"1652";"86,56";3509908
"Cananéia";"2019";"12315";"6136";"6179";"99,3";"10674";"1641";"86,67";3509908
"Cananéia";"2020";"12341";"6144";"6197";"99,14";"10710";"1631";"86,78";3509908
"Canas";"2016";"4797";"2419";"2378";"101,72";"4567";"230";"95,21";3509957
"Canas";"2017";"4862";"2449";"2413";"101,49";"4643";"219";"95,5";3509957
"Canas";"2018";"4929";"2480";"2449";"101,27";"4719";"210";"95,74";3509957
"Canas";"2019";"4996";"2511";"2485";"101,05";"4794";"202";"95,96";3509957
"Canas";"2020";"5064";"2543";"2521";"100,87";"4870";"194";"96,17";3509957
"Cândido Mota";"2016";"29976";"14682";"15294";"96";"28412";"1564";"94,78";3510005
"Cândido Mota";"2017";"29987";"14685";"15302";"95,97";"28448";"1539";"94,87";3510005
"Cândido Mota";"2018";"29997";"14687";"15310";"95,93";"28479";"1518";"94,94";3510005
"Cândido Mota";"2019";"30008";"14690";"15318";"95,9";"28509";"1499";"95";3510005
"Cândido Mota";"2020";"30019";"14693";"15326";"95,87";"28537";"1482";"95,06";3510005
"Cândido Rodrigues";"2016";"2675";"1310";"1365";"95,97";"2240";"435";"83,74";3510104
"Cândido Rodrigues";"2017";"2675";"1309";"1366";"95,83";"2252";"423";"84,19";3510104
"Cândido Rodrigues";"2018";"2674";"1308";"1366";"95,75";"2263";"411";"84,63";3510104
"Cândido Rodrigues";"2019";"2674";"1307";"1367";"95,61";"2275";"399";"85,08";3510104
"Cândido Rodrigues";"2020";"2674";"1306";"1368";"95,47";"2286";"388";"85,49";3510104
"Canitar";"2016";"4736";"2393";"2343";"102,13";"4518";"218";"95,4";3510153
"Canitar";"2017";"4798";"2423";"2375";"102,02";"4579";"219";"95,44";3510153
"Canitar";"2018";"4862";"2454";"2408";"101,91";"4641";"221";"95,45";3510153
"Canitar";"2019";"4926";"2485";"2441";"101,8";"4703";"223";"95,47";3510153
"Canitar";"2020";"4991";"2516";"2475";"101,66";"4766";"225";"95,49";3510153
"Capão Bonito";"2016";"46190";"22971";"23219";"98,93";"38720";"7470";"83,83";3510203
"Capão Bonito";"2017";"46247";"22992";"23255";"98,87";"38908";"7339";"84,13";3510203
"Capão Bonito";"2018";"46303";"23012";"23291";"98,8";"39093";"7210";"84,43";3510203
"Capão Bonito";"2019";"46361";"23033";"23328";"98,74";"39277";"7084";"84,72";3510203
"Capão Bonito";"2020";"46418";"23054";"23364";"98,67";"39459";"6959";"85,01";3510203
"Capela do Alto";"2016";"19304";"9911";"9393";"105,51";"16462";"2842";"85,28";3510302
"Capela do Alto";"2017";"19606";"10059";"9547";"105,36";"16794";"2812";"85,66";3510302
"Capela do Alto";"2018";"19913";"10209";"9704";"105,2";"17130";"2783";"86,02";3510302
"Capela do Alto";"2019";"20225";"10362";"9863";"105,06";"17471";"2754";"86,38";3510302
"Capela do Alto";"2020";"20542";"10517";"10025";"104,91";"17817";"2725";"86,73";3510302
"Capivari";"2016";"51993";"25998";"25995";"100,01";"50368";"1625";"96,87";3510401
"Capivari";"2017";"52543";"26264";"26279";"99,94";"51015";"1528";"97,09";3510401
"Capivari";"2018";"53100";"26533";"26567";"99,87";"51653";"1447";"97,27";3510401
"Capivari";"2019";"53662";"26804";"26858";"99,8";"52283";"1379";"97,43";3510401
"Capivari";"2020";"54231";"27079";"27152";"99,73";"52908";"1323";"97,56";3510401
"Caraguatatuba";"2016";"110384";"54359";"56025";"97,03";"106111";"4273";"96,13";3510500
"Caraguatatuba";"2017";"111787";"55004";"56783";"96,87";"107505";"4282";"96,17";3510500
"Caraguatatuba";"2018";"113208";"55656";"57552";"96,71";"108916";"4292";"96,21";3510500
"Caraguatatuba";"2019";"114648";"56316";"58332";"96,54";"110345";"4303";"96,25";3510500
"Caraguatatuba";"2020";"116106";"56984";"59122";"96,38";"111793";"4313";"96,29";3510500
"Carapicuíba";"2016";"385474";"187191";"198283";"94,41";"385474";"-";"100";3510609
"Carapicuíba";"2017";"387735";"188297";"199438";"94,41";"387735";"-";"100";3510609
"Carapicuíba";"2018";"390010";"189410";"200600";"94,42";"390010";"-";"100";3510609
"Carapicuíba";"2019";"392297";"190529";"201768";"94,43";"392297";"-";"100";3510609
"Carapicuíba";"2020";"394598";"191655";"202943";"94,44";"394598";"-";"100";3510609
"Cardoso";"2016";"11759";"5772";"5987";"96,41";"10771";"988";"91,6";3510708
"Cardoso";"2017";"11749";"5763";"5986";"96,27";"10774";"975";"91,7";3510708
"Cardoso";"2018";"11740";"5754";"5986";"96,12";"10777";"963";"91,8";3510708
"Cardoso";"2019";"11730";"5745";"5985";"95,99";"10779";"951";"91,89";3510708
"Cardoso";"2020";"11721";"5736";"5985";"95,84";"10781";"940";"91,98";3510708
"Casa Branca";"2016";"29013";"15268";"13745";"111,08";"23914";"5099";"82,43";3510807
"Casa Branca";"2017";"29124";"15311";"13813";"110,84";"24035";"5089";"82,53";3510807
"Casa Branca";"2018";"29236";"15355";"13881";"110,62";"24157";"5079";"82,63";3510807
"Casa Branca";"2019";"29348";"15399";"13949";"110,4";"24280";"5068";"82,73";3510807
"Casa Branca";"2020";"29462";"15444";"14018";"110,17";"24404";"5058";"82,83";3510807
"Cássia dos Coqueiros";"2016";"2542";"1295";"1247";"103,85";"1870";"672";"73,56";3510906
"Cássia dos Coqueiros";"2017";"2529";"1287";"1242";"103,62";"1881";"648";"74,38";3510906
"Cássia dos Coqueiros";"2018";"2518";"1280";"1238";"103,39";"1894";"624";"75,22";3510906
"Cássia dos Coqueiros";"2019";"2506";"1273";"1233";"103,24";"1905";"601";"76,02";3510906
"Cássia dos Coqueiros";"2020";"2495";"1266";"1229";"103,01";"1916";"579";"76,79";3510906
"Castilho";"2016";"19668";"9754";"9914";"98,39";"14842";"4826";"75,46";3511003
"Castilho";"2017";"19929";"9878";"10051";"98,28";"15039";"4890";"75,46";3511003
"Castilho";"2018";"20191";"10002";"10189";"98,16";"15237";"4954";"75,46";3511003
"Castilho";"2019";"20458";"10128";"10330";"98,04";"15439";"5019";"75,47";3511003
"Castilho";"2020";"20728";"10256";"10472";"97,94";"15642";"5086";"75,46";3511003
"Catanduva";"2016";"115669";"56131";"59538";"94,28";"114740";"929";"99,2";3511102
"Catanduva";"2017";"116051";"56316";"59735";"94,28";"115119";"932";"99,2";3511102
"Catanduva";"2018";"116435";"56501";"59934";"94,27";"115500";"935";"99,2";3511102
"Catanduva";"2019";"116819";"56687";"60132";"94,27";"115881";"938";"99,2";3511102
"Catanduva";"2020";"117206";"56874";"60332";"94,27";"116265";"941";"99,2";3511102
"Catiguá";"2016";"7382";"3741";"3641";"102,75";"6851";"531";"92,81";3511201
"Catiguá";"2017";"7418";"3756";"3662";"102,57";"6891";"527";"92,9";3511201
"Catiguá";"2018";"7455";"3771";"3684";"102,36";"6931";"524";"92,97";3511201
"Catiguá";"2019";"7492";"3787";"3705";"102,21";"6971";"521";"93,05";3511201
"Catiguá";"2020";"7529";"3802";"3727";"102,01";"7010";"519";"93,11";3511201
"Caçapava";"2016";"88913";"43965";"44948";"97,81";"76077";"12836";"85,56";3508504
"Caçapava";"2017";"89483";"44231";"45252";"97,74";"76565";"12918";"85,56";3508504
"Caçapava";"2018";"90057";"44499";"45558";"97,68";"77056";"13001";"85,56";3508504
"Caçapava";"2019";"90636";"44769";"45867";"97,61";"77552";"13084";"85,56";3508504
"Caçapava";"2020";"91217";"45040";"46177";"97,54";"78049";"13168";"85,56";3508504
"Cedral";"2016";"8513";"4231";"4282";"98,81";"6938";"1575";"81,5";3511300
"Cedral";"2017";"8592";"4268";"4324";"98,7";"7034";"1558";"81,87";3511300
"Cedral";"2018";"8673";"4307";"4366";"98,65";"7131";"1542";"82,22";3511300
"Cedral";"2019";"8754";"4345";"4409";"98,55";"7228";"1526";"82,57";3511300
"Cedral";"2020";"8836";"4384";"4452";"98,47";"7326";"1510";"82,91";3511300
"Cerqueira César";"2016";"18553";"9147";"9406";"97,25";"16935";"1618";"91,28";3511409
"Cerqueira César";"2017";"18716";"9223";"9493";"97,16";"17130";"1586";"91,53";3511409
"Cerqueira César";"2018";"18879";"9299";"9580";"97,07";"17324";"1555";"91,76";3511409
"Cerqueira César";"2019";"19046";"9377";"9669";"96,98";"17521";"1525";"91,99";3511409
"Cerqueira César";"2020";"19213";"9455";"9758";"96,89";"17718";"1495";"92,22";3511409
"Cerquilho";"2016";"43949";"21745";"22204";"97,93";"41675";"2274";"94,83";3511508
"Cerquilho";"2017";"44552";"22038";"22514";"97,89";"42247";"2305";"94,83";3511508
"Cerquilho";"2018";"45164";"22336";"22828";"97,84";"42827";"2337";"94,83";3511508
"Cerquilho";"2019";"45783";"22637";"23146";"97,8";"43414";"2369";"94,83";3511508
"Cerquilho";"2020";"46411";"22942";"23469";"97,75";"44009";"2402";"94,82";3511508
"Cesário Lange";"2016";"16659";"8617";"8042";"107,15";"11248";"5411";"67,52";3511607
"Cesário Lange";"2017";"16805";"8688";"8117";"107,03";"11346";"5459";"67,52";3511607
"Cesário Lange";"2018";"16951";"8760";"8191";"106,95";"11445";"5506";"67,52";3511607
"Cesário Lange";"2019";"17099";"8832";"8267";"106,83";"11545";"5554";"67,52";3511607
"Cesário Lange";"2020";"17248";"8905";"8343";"106,74";"11645";"5603";"67,52";3511607
"Charqueada";"2016";"16217";"8230";"7987";"103,04";"14788";"1429";"91,19";3511706
"Charqueada";"2017";"16394";"8315";"8079";"102,92";"14962";"1432";"91,27";3511706
"Charqueada";"2018";"16571";"8400";"8171";"102,8";"15136";"1435";"91,34";3511706
"Charqueada";"2019";"16751";"8487";"8264";"102,7";"15312";"1439";"91,41";3511706
"Charqueada";"2020";"16933";"8574";"8359";"102,57";"15491";"1442";"91,48";3511706
"Chavantes";"2016";"12179";"6044";"6135";"98,52";"11403";"776";"93,63";3557204
"Chavantes";"2017";"12190";"6047";"6143";"98,44";"11437";"753";"93,82";3557204
"Chavantes";"2018";"12201";"6049";"6152";"98,33";"11468";"733";"93,99";3557204
"Chavantes";"2019";"12212";"6052";"6160";"98,25";"11498";"714";"94,15";3557204
"Chavantes";"2020";"12223";"6055";"6168";"98,17";"11525";"698";"94,29";3557204
"Clementina";"2016";"7856";"4060";"3796";"106,95";"7574";"282";"96,41";3511904
"Clementina";"2017";"7970";"4117";"3853";"106,85";"7695";"275";"96,55";3511904
"Clementina";"2018";"8087";"4175";"3912";"106,72";"7818";"269";"96,67";3511904
"Clementina";"2019";"8205";"4234";"3971";"106,62";"7942";"263";"96,79";3511904
"Clementina";"2020";"8324";"4293";"4031";"106,5";"8066";"258";"96,9";3511904
"Colina";"2016";"17533";"8652";"8881";"97,42";"16608";"925";"94,72";3512001
"Colina";"2017";"17550";"8654";"8896";"97,28";"16654";"896";"94,89";3512001
"Colina";"2018";"17568";"8656";"8912";"97,13";"16699";"869";"95,05";3512001
"Colina";"2019";"17585";"8658";"8927";"96,99";"16740";"845";"95,19";3512001
"Colina";"2020";"17603";"8660";"8943";"96,84";"16781";"822";"95,33";3512001
"Colômbia";"2016";"6029";"3058";"2971";"102,93";"4462";"1567";"74,01";3512100
"Colômbia";"2017";"6034";"3057";"2977";"102,69";"4482";"1552";"74,28";3512100
"Colômbia";"2018";"6037";"3055";"2982";"102,45";"4501";"1536";"74,56";3512100
"Colômbia";"2019";"6042";"3054";"2988";"102,21";"4522";"1520";"74,84";3512100
"Colômbia";"2020";"6046";"3052";"2994";"101,94";"4541";"1505";"75,11";3512100
"Conchal";"2016";"26484";"13345";"13139";"101,57";"25432";"1052";"96,03";3512209
"Conchal";"2017";"26682";"13437";"13245";"101,45";"25672";"1010";"96,21";3512209
"Conchal";"2018";"26881";"13529";"13352";"101,33";"25910";"971";"96,39";3512209
"Conchal";"2019";"27081";"13622";"13459";"101,21";"26146";"935";"96,55";3512209
"Conchal";"2020";"27284";"13716";"13568";"101,09";"26382";"902";"96,69";3512209
"Conchas";"2016";"16799";"8404";"8395";"100,11";"14069";"2730";"83,75";3512308
"Conchas";"2017";"16882";"8441";"8441";"100";"14209";"2673";"84,17";3512308
"Conchas";"2018";"16966";"8478";"8488";"99,88";"14350";"2616";"84,58";3512308
"Conchas";"2019";"17050";"8515";"8535";"99,77";"14489";"2561";"84,98";3512308
"Conchas";"2020";"17134";"8552";"8582";"99,65";"14628";"2506";"85,37";3512308
"Cordeirópolis";"2016";"23123";"11605";"11518";"100,76";"20769";"2354";"89,82";3512407
"Cordeirópolis";"2017";"23425";"11755";"11670";"100,73";"21040";"2385";"89,82";3512407
"Cordeirópolis";"2018";"23732";"11907";"11825";"100,69";"21316";"2416";"89,82";3512407
"Cordeirópolis";"2019";"24041";"12060";"11981";"100,66";"21594";"2447";"89,82";3512407
"Cordeirópolis";"2020";"24356";"12216";"12140";"100,63";"21876";"2480";"89,82";3512407
"Coroados";"2016";"5680";"2821";"2859";"98,67";"4771";"909";"84";3512506
"Coroados";"2017";"5740";"2850";"2890";"98,62";"4847";"893";"84,44";3512506
"Coroados";"2018";"5802";"2880";"2922";"98,56";"4925";"877";"84,88";3512506
"Coroados";"2019";"5864";"2910";"2954";"98,51";"5003";"861";"85,32";3512506
"Coroados";"2020";"5926";"2940";"2986";"98,46";"5081";"845";"85,74";3512506
"Coronel Macedo";"2016";"4884";"2490";"2394";"104,01";"3916";"968";"80,18";3512605
"Coronel Macedo";"2017";"4874";"2483";"2391";"103,85";"3930";"944";"80,63";3512605
"Coronel Macedo";"2018";"4864";"2477";"2387";"103,77";"3944";"920";"81,09";3512605
"Coronel Macedo";"2019";"4854";"2470";"2384";"103,61";"3957";"897";"81,52";3512605
"Coronel Macedo";"2020";"4843";"2463";"2380";"103,49";"3969";"874";"81,95";3512605
"Corumbataí";"2016";"3928";"1983";"1945";"101,95";"2324";"1604";"59,16";3512704
"Corumbataí";"2017";"3936";"1985";"1951";"101,74";"2362";"1574";"60,01";3512704
"Corumbataí";"2018";"3945";"1987";"1958";"101,48";"2400";"1545";"60,84";3512704
"Corumbataí";"2019";"3953";"1989";"1964";"101,27";"2437";"1516";"61,65";3512704
"Corumbataí";"2020";"3962";"1991";"1971";"101,01";"2475";"1487";"62,47";3512704
"Cosmópolis";"2016";"66478";"33100";"33378";"99,17";"61740";"4738";"92,87";3512803
"Cosmópolis";"2017";"67647";"33663";"33984";"99,06";"62825";"4822";"92,87";3512803
"Cosmópolis";"2018";"68838";"34236";"34602";"98,94";"63931";"4907";"92,87";3512803
"Cosmópolis";"2019";"70050";"34819";"35231";"98,83";"65057";"4993";"92,87";3512803
"Cosmópolis";"2020";"71282";"35411";"35871";"98,72";"66201";"5081";"92,87";3512803
"Cosmorama";"2016";"7079";"3551";"3528";"100,65";"5216";"1863";"73,68";3512902
"Cosmorama";"2017";"7059";"3536";"3523";"100,37";"5256";"1803";"74,46";3512902
"Cosmorama";"2018";"7038";"3520";"3518";"100,06";"5294";"1744";"75,22";3512902
"Cosmorama";"2019";"7017";"3504";"3513";"99,74";"5330";"1687";"75,96";3512902
"Cosmorama";"2020";"6997";"3489";"3508";"99,46";"5364";"1633";"76,66";3512902
"Cotia";"2016";"229300";"112211";"117089";"95,83";"229300";"-";"100";3513009
"Cotia";"2017";"233703";"114359";"119344";"95,82";"233703";"-";"100";3513009
"Cotia";"2018";"238189";"116548";"121641";"95,81";"238189";"-";"100";3513009
"Cotia";"2019";"242763";"118779";"123984";"95,8";"242763";"-";"100";3513009
"Cotia";"2020";"247424";"121053";"126371";"95,79";"247424";"-";"100";3513009
"Cravinhos";"2016";"33372";"16667";"16705";"99,77";"32768";"604";"98,19";3513108
"Cravinhos";"2017";"33633";"16787";"16846";"99,65";"33055";"578";"98,28";3513108
"Cravinhos";"2018";"33896";"16909";"16987";"99,54";"33342";"554";"98,37";3513108
"Cravinhos";"2019";"34161";"17031";"17130";"99,42";"33630";"531";"98,45";3513108
"Cravinhos";"2020";"34428";"17154";"17274";"99,31";"33919";"509";"98,52";3513108
"Cristais Paulista";"2016";"8109";"4120";"3989";"103,28";"6435";"1674";"79,36";3513207
"Cristais Paulista";"2017";"8187";"4156";"4031";"103,1";"6575";"1612";"80,31";3513207
"Cristais Paulista";"2018";"8265";"4192";"4073";"102,92";"6713";"1552";"81,22";3513207
"Cristais Paulista";"2019";"8344";"4228";"4116";"102,72";"6850";"1494";"82,09";3513207
"Cristais Paulista";"2020";"8425";"4265";"4160";"102,52";"6987";"1438";"82,93";3513207
"Cruzália";"2016";"2172";"1053";"1119";"94,1";"1507";"665";"69,38";3513306
"Cruzália";"2017";"2158";"1046";"1112";"94,06";"1507";"651";"69,83";3513306
"Cruzália";"2018";"2144";"1038";"1106";"93,85";"1508";"636";"70,34";3513306
"Cruzália";"2019";"2130";"1030";"1100";"93,64";"1508";"622";"70,8";3513306
"Cruzália";"2020";"2117";"1023";"1094";"93,51";"1508";"609";"71,23";3513306
"Cruzeiro";"2016";"78848";"38329";"40519";"94,6";"76990";"1858";"97,64";3513405
"Cruzeiro";"2017";"79117";"38451";"40666";"94,55";"77271";"1846";"97,67";3513405
"Cruzeiro";"2018";"79386";"38573";"40813";"94,51";"77552";"1834";"97,69";3513405
"Cruzeiro";"2019";"79656";"38695";"40961";"94,47";"77832";"1824";"97,71";3513405
"Cruzeiro";"2020";"79927";"38818";"41109";"94,43";"78112";"1815";"97,73";3513405
"Cubatão";"2016";"125047";"62195";"62852";"98,95";"125047";"-";"100";3513504
"Cubatão";"2017";"126059";"62670";"63389";"98,87";"126059";"-";"100";3513504
"Cubatão";"2018";"127079";"63148";"63931";"98,78";"127079";"-";"100";3513504
"Cubatão";"2019";"128108";"63630";"64478";"98,68";"128108";"-";"100";3513504
"Cubatão";"2020";"129145";"64116";"65029";"98,6";"129145";"-";"100";3513504
"Cunha";"2016";"21694";"11030";"10664";"103,43";"13011";"8683";"59,98";3513603
"Cunha";"2017";"21691";"11020";"10671";"103,27";"13162";"8529";"60,68";3513603
"Cunha";"2018";"21687";"11010";"10677";"103,12";"13312";"8375";"61,38";3513603
"Cunha";"2019";"21684";"11000";"10684";"102,96";"13461";"8223";"62,08";3513603
"Cunha";"2020";"21681";"10990";"10691";"102,8";"13609";"8072";"62,77";3513603
"Descalvado";"2016";"31923";"15711";"16212";"96,91";"29221";"2702";"91,54";3513702
"Descalvado";"2017";"32048";"15766";"16282";"96,83";"29437";"2611";"91,85";3513702
"Descalvado";"2018";"32176";"15822";"16354";"96,75";"29651";"2525";"92,15";3513702
"Descalvado";"2019";"32302";"15877";"16425";"96,66";"29858";"2444";"92,43";3513702
"Descalvado";"2020";"32430";"15933";"16497";"96,58";"30064";"2366";"92,7";3513702
"Diadema";"2016";"397868";"192477";"205391";"93,71";"397868";"-";"100";3513801
"Diadema";"2017";"399510";"193265";"206245";"93,71";"399510";"-";"100";3513801
"Diadema";"2018";"401159";"194056";"207103";"93,7";"401159";"-";"100";3513801
"Diadema";"2019";"402813";"194850";"207963";"93,69";"402813";"-";"100";3513801
"Diadema";"2020";"404477";"195649";"208828";"93,69";"404477";"-";"100";3513801
"Dirce Reis";"2016";"1710";"873";"837";"104,3";"1370";"340";"80,12";3513850
"Dirce Reis";"2017";"1712";"872";"840";"103,81";"1382";"330";"80,72";3513850
"Dirce Reis";"2018";"1713";"870";"843";"103,2";"1394";"319";"81,38";3513850
"Dirce Reis";"2019";"1715";"869";"846";"102,72";"1406";"309";"81,98";3513850
"Dirce Reis";"2020";"1717";"868";"849";"102,24";"1417";"300";"82,53";3513850
"Divinolândia";"2016";"10993";"5440";"5553";"97,97";"7927";"3066";"72,11";3513900
"Divinolândia";"2017";"10966";"5421";"5545";"97,76";"7996";"2970";"72,92";3513900
"Divinolândia";"2018";"10940";"5402";"5538";"97,54";"8064";"2876";"73,71";3513900
"Divinolândia";"2019";"10913";"5383";"5530";"97,34";"8129";"2784";"74,49";3513900
"Divinolândia";"2020";"10886";"5364";"5522";"97,14";"8192";"2694";"75,25";3513900
"Dobrada";"2016";"8521";"4389";"4132";"106,22";"8331";"190";"97,77";3514007
"Dobrada";"2017";"8615";"4433";"4182";"106";"8423";"192";"97,77";3514007
"Dobrada";"2018";"8710";"4478";"4232";"105,81";"8516";"194";"97,77";3514007
"Dobrada";"2019";"8806";"4523";"4283";"105,6";"8610";"196";"97,77";3514007
"Dobrada";"2020";"8904";"4569";"4335";"105,4";"8705";"199";"97,77";3514007
"Dois Córregos";"2016";"26087";"13046";"13041";"100,04";"25089";"998";"96,17";3514106
"Dois Córregos";"2017";"26305";"13152";"13153";"99,99";"25347";"958";"96,36";3514106
"Dois Córregos";"2018";"26526";"13260";"13266";"99,95";"25604";"922";"96,52";3514106
"Dois Córregos";"2019";"26748";"13368";"13380";"99,91";"25859";"889";"96,68";3514106
"Dois Córregos";"2020";"26972";"13477";"13495";"99,87";"26113";"859";"96,82";3514106
"Dolcinópolis";"2016";"2063";"1069";"994";"107,55";"1933";"130";"93,7";3514205
"Dolcinópolis";"2017";"2058";"1066";"992";"107,46";"1930";"128";"93,78";3514205
"Dolcinópolis";"2018";"2051";"1062";"989";"107,38";"1924";"127";"93,81";3514205
"Dolcinópolis";"2019";"2046";"1059";"987";"107,29";"1920";"126";"93,84";3514205
"Dolcinópolis";"2020";"2040";"1056";"984";"107,32";"1915";"125";"93,87";3514205
"Dourado";"2016";"8528";"4300";"4228";"101,7";"7811";"717";"91,59";3514304
"Dourado";"2017";"8516";"4290";"4226";"101,51";"7802";"714";"91,62";3514304
"Dourado";"2018";"8506";"4281";"4225";"101,33";"7795";"711";"91,64";3514304
"Dourado";"2019";"8494";"4271";"4223";"101,14";"7787";"707";"91,68";3514304
"Dourado";"2020";"8482";"4261";"4221";"100,95";"7778";"704";"91,7";3514304
"Dracena";"2016";"44396";"21867";"22529";"97,06";"41147";"3249";"92,68";3514403
"Dracena";"2017";"44545";"21931";"22614";"96,98";"41309";"3236";"92,74";3514403
"Dracena";"2018";"44694";"21995";"22699";"96,9";"41471";"3223";"92,79";3514403
"Dracena";"2019";"44844";"22059";"22785";"96,81";"41634";"3210";"92,84";3514403
"Dracena";"2020";"44995";"22124";"22871";"96,73";"41798";"3197";"92,89";3514403
"Duartina";"2016";"12088";"5861";"6227";"94,12";"11040";"1048";"91,33";3514502
"Duartina";"2017";"12059";"5842";"6217";"93,97";"11042";"1017";"91,57";3514502
"Duartina";"2018";"12031";"5824";"6207";"93,83";"11044";"987";"91,8";3514502
"Duartina";"2019";"12003";"5806";"6197";"93,69";"11044";"959";"92,01";3514502
"Duartina";"2020";"11975";"5788";"6187";"93,55";"11044";"931";"92,23";3514502
"Dumont";"2016";"9079";"4548";"4531";"100,38";"8862";"217";"97,61";3514601
"Dumont";"2017";"9200";"4605";"4595";"100,22";"8993";"207";"97,75";3514601
"Dumont";"2018";"9321";"4662";"4659";"100,06";"9125";"196";"97,9";3514601
"Dumont";"2019";"9445";"4720";"4725";"99,89";"9258";"187";"98,02";3514601
"Dumont";"2020";"9570";"4779";"4791";"99,75";"9392";"178";"98,14";3514601
"Echaporã";"2016";"6253";"3072";"3181";"96,57";"5101";"1152";"81,58";3514700
"Echaporã";"2017";"6244";"3066";"3178";"96,48";"5112";"1132";"81,87";3514700
"Echaporã";"2018";"6235";"3060";"3175";"96,38";"5124";"1111";"82,18";3514700
"Echaporã";"2019";"6226";"3054";"3172";"96,28";"5134";"1092";"82,46";3514700
"Echaporã";"2020";"6217";"3048";"3169";"96,18";"5145";"1072";"82,76";3514700
"Eldorado";"2016";"14909";"7561";"7348";"102,9";"7337";"7572";"49,21";3514809
"Eldorado";"2017";"14990";"7594";"7396";"102,68";"7377";"7613";"49,21";3514809
"Eldorado";"2018";"15072";"7627";"7445";"102,44";"7417";"7655";"49,21";3514809
"Eldorado";"2019";"15154";"7660";"7494";"102,22";"7457";"7697";"49,21";3514809
"Eldorado";"2020";"15236";"7693";"7543";"101,99";"7498";"7738";"49,21";3514809
"Elias Fausto";"2016";"16756";"8640";"8116";"106,46";"13822";"2934";"82,49";3514908
"Elias Fausto";"2017";"16901";"8709";"8192";"106,31";"14017";"2884";"82,94";3514908
"Elias Fausto";"2018";"17048";"8779";"8269";"106,17";"14213";"2835";"83,37";3514908
"Elias Fausto";"2019";"17197";"8850";"8347";"106,03";"14410";"2787";"83,79";3514908
"Elias Fausto";"2020";"17346";"8921";"8425";"105,89";"14606";"2740";"84,2";3514908
"Elisiário";"2016";"3359";"1757";"1602";"109,68";"3121";"238";"92,91";3514924
"Elisiário";"2017";"3393";"1772";"1621";"109,32";"3157";"236";"93,04";3514924
"Elisiário";"2018";"3428";"1787";"1641";"108,9";"3194";"234";"93,17";3514924
"Elisiário";"2019";"3464";"1802";"1662";"108,42";"3231";"233";"93,27";3514924
"Elisiário";"2020";"3499";"1817";"1682";"108,03";"3267";"232";"93,37";3514924
"Embaúba";"2016";"2408";"1249";"1159";"107,77";"2105";"303";"87,42";3514957
"Embaúba";"2017";"2408";"1248";"1160";"107,59";"2114";"294";"87,79";3514957
"Embaúba";"2018";"2409";"1248";"1161";"107,49";"2123";"286";"88,13";3514957
"Embaúba";"2019";"2409";"1247";"1162";"107,31";"2131";"278";"88,46";3514957
"Embaúba";"2020";"2409";"1246";"1163";"107,14";"2139";"270";"88,79";3514957
"Embu das Artes";"2016";"258917";"125830";"133087";"94,55";"258917";"-";"100";3515004
"Embu das Artes";"2017";"261836";"127251";"134585";"94,55";"261836";"-";"100";3515004
"Embu das Artes";"2018";"264787";"128687";"136100";"94,55";"264787";"-";"100";3515004
"Embu das Artes";"2019";"267771";"130139";"137632";"94,56";"267771";"-";"100";3515004
"Embu das Artes";"2020";"270790";"131608";"139182";"94,56";"270790";"-";"100";3515004
"Embu-Guaçu";"2016";"65950";"32674";"33276";"98,19";"64191";"1759";"97,33";3515103
"Embu-Guaçu";"2017";"66470";"32917";"33553";"98,1";"64697";"1773";"97,33";3515103
"Embu-Guaçu";"2018";"66993";"33161";"33832";"98,02";"65206";"1787";"97,33";3515103
"Embu-Guaçu";"2019";"67521";"33408";"34113";"97,93";"65720";"1801";"97,33";3515103
"Embu-Guaçu";"2020";"68053";"33656";"34397";"97,85";"66238";"1815";"97,33";3515103
"Emilianópolis";"2016";"3057";"1529";"1528";"100,07";"2627";"430";"85,93";3515129
"Emilianópolis";"2017";"3059";"1530";"1529";"100,07";"2643";"416";"86,4";3515129
"Emilianópolis";"2018";"3063";"1532";"1531";"100,07";"2661";"402";"86,88";3515129
"Emilianópolis";"2019";"3065";"1533";"1532";"100,07";"2676";"389";"87,31";3515129
"Emilianópolis";"2020";"3068";"1534";"1534";"100";"2692";"376";"87,74";3515129
"Engenheiro Coelho";"2016";"18761";"9772";"8989";"108,71";"14067";"4694";"74,98";3515152
"Engenheiro Coelho";"2017";"19190";"9987";"9203";"108,52";"14446";"4744";"75,28";3515152
"Engenheiro Coelho";"2018";"19628";"10207";"9421";"108,34";"14834";"4794";"75,58";3515152
"Engenheiro Coelho";"2019";"20077";"10432";"9645";"108,16";"15232";"4845";"75,87";3515152
"Engenheiro Coelho";"2020";"20535";"10661";"9874";"107,97";"15639";"4896";"76,16";3515152
"Espírito Santo do Pinhal";"2016";"42350";"20704";"21646";"95,65";"38266";"4084";"90,36";3515186
"Espírito Santo do Pinhal";"2017";"42405";"20729";"21676";"95,63";"38412";"3993";"90,58";3515186
"Espírito Santo do Pinhal";"2018";"42461";"20754";"21707";"95,61";"38555";"3906";"90,8";3515186
"Espírito Santo do Pinhal";"2019";"42517";"20779";"21738";"95,59";"38697";"3820";"91,02";3515186
"Espírito Santo do Pinhal";"2020";"42573";"20804";"21769";"95,57";"38837";"3736";"91,22";3515186
"Espírito Santo do Turvo";"2016";"4573";"2294";"2279";"100,66";"3911";"662";"85,52";3515194
"Espírito Santo do Turvo";"2017";"4629";"2319";"2310";"100,39";"3959";"670";"85,53";3515194
"Espírito Santo do Turvo";"2018";"4685";"2344";"2341";"100,13";"4007";"678";"85,53";3515194
"Espírito Santo do Turvo";"2019";"4741";"2369";"2372";"99,87";"4055";"686";"85,53";3515194
"Espírito Santo do Turvo";"2020";"4799";"2395";"2404";"99,63";"4105";"694";"85,54";3515194
"Estiva Gerbi";"2016";"10678";"5350";"5328";"100,41";"8517";"2161";"79,76";3557303
"Estiva Gerbi";"2017";"10777";"5393";"5384";"100,17";"8596";"2181";"79,76";3557303
"Estiva Gerbi";"2018";"10877";"5436";"5441";"99,91";"8675";"2202";"79,76";3557303
"Estiva Gerbi";"2019";"10977";"5479";"5498";"99,65";"8755";"2222";"79,76";3557303
"Estiva Gerbi";"2020";"11079";"5523";"5556";"99,41";"8837";"2242";"79,76";3557303
"Estrela d'Oeste";"2016";"8144";"4088";"4056";"100,79";"6989";"1155";"85,82";3515202
"Estrela d'Oeste";"2017";"8132";"4080";"4052";"100,69";"7009";"1123";"86,19";3515202
"Estrela d'Oeste";"2018";"8119";"4072";"4047";"100,62";"7027";"1092";"86,55";3515202
"Estrela d'Oeste";"2019";"8107";"4064";"4043";"100,52";"7044";"1063";"86,89";3515202
"Estrela d'Oeste";"2020";"8094";"4056";"4038";"100,45";"7059";"1035";"87,21";3515202
"Estrela do Norte";"2016";"2656";"1360";"1296";"104,94";"2229";"427";"83,92";3515301
"Estrela do Norte";"2017";"2658";"1359";"1299";"104,62";"2249";"409";"84,61";3515301
"Estrela do Norte";"2018";"2661";"1359";"1302";"104,38";"2270";"391";"85,31";3515301
"Estrela do Norte";"2019";"2663";"1358";"1305";"104,06";"2289";"374";"85,96";3515301
"Estrela do Norte";"2020";"2665";"1357";"1308";"103,75";"2307";"358";"86,57";3515301
"Euclides da Cunha Paulista";"2016";"9507";"4756";"4751";"100,11";"6106";"3401";"64,23";3515350
"Euclides da Cunha Paulista";"2017";"9514";"4755";"4759";"99,92";"6118";"3396";"64,31";3515350
"Euclides da Cunha Paulista";"2018";"9523";"4755";"4768";"99,73";"6131";"3392";"64,38";3515350
"Euclides da Cunha Paulista";"2019";"9530";"4754";"4776";"99,54";"6143";"3387";"64,46";3515350
"Euclides da Cunha Paulista";"2020";"9537";"4753";"4784";"99,35";"6155";"3382";"64,54";3515350
"Fartura";"2016";"15497";"7492";"8005";"93,59";"12716";"2781";"82,05";3515400
"Fartura";"2017";"15534";"7507";"8027";"93,52";"12799";"2735";"82,39";3515400
"Fartura";"2018";"15570";"7521";"8049";"93,44";"12881";"2689";"82,73";3515400
"Fartura";"2019";"15608";"7536";"8072";"93,36";"12964";"2644";"83,06";3515400
"Fartura";"2020";"15644";"7550";"8094";"93,28";"13045";"2599";"83,39";3515400
"Fernando Prestes";"2016";"5563";"2721";"2842";"95,74";"4930";"633";"88,62";3515608
"Fernando Prestes";"2017";"5566";"2720";"2846";"95,57";"4961";"605";"89,13";3515608
"Fernando Prestes";"2018";"5567";"2718";"2849";"95,4";"4989";"578";"89,62";3515608
"Fernando Prestes";"2019";"5570";"2717";"2853";"95,23";"5017";"553";"90,07";3515608
"Fernando Prestes";"2020";"5572";"2716";"2856";"95,1";"5043";"529";"90,51";3515608
"Fernandópolis";"2016";"65663";"31894";"33769";"94,45";"63651";"2012";"96,94";3515509
"Fernandópolis";"2017";"65776";"31936";"33840";"94,37";"63761";"2015";"96,94";3515509
"Fernandópolis";"2018";"65887";"31977";"33910";"94,3";"63869";"2018";"96,94";3515509
"Fernandópolis";"2019";"65999";"32018";"33981";"94,22";"63977";"2022";"96,94";3515509
"Fernandópolis";"2020";"66112";"32060";"34052";"94,15";"64087";"2025";"96,94";3515509
"Fernão";"2016";"1613";"814";"799";"101,88";"944";"669";"58,52";3515657
"Fernão";"2017";"1622";"818";"804";"101,74";"960";"662";"59,19";3515657
"Fernão";"2018";"1631";"821";"810";"101,36";"977";"654";"59,9";3515657
"Fernão";"2019";"1640";"825";"815";"101,23";"993";"647";"60,55";3515657
"Fernão";"2020";"1649";"828";"821";"100,85";"1009";"640";"61,19";3515657
"Ferraz de Vasconcelos";"2016";"183163";"89438";"93725";"95,43";"174944";"8219";"95,51";3515707
"Ferraz de Vasconcelos";"2017";"185584";"90625";"94959";"95,44";"177257";"8327";"95,51";3515707
"Ferraz de Vasconcelos";"2018";"188035";"91827";"96208";"95,45";"179598";"8437";"95,51";3515707
"Ferraz de Vasconcelos";"2019";"190519";"93045";"97474";"95,46";"181970";"8549";"95,51";3515707
"Ferraz de Vasconcelos";"2020";"193037";"94280";"98757";"95,47";"184375";"8662";"95,51";3515707
"Flora Rica";"2016";"1641";"817";"824";"99,15";"1395";"246";"85,01";3515806
"Flora Rica";"2017";"1628";"810";"818";"99,02";"1394";"234";"85,63";3515806
"Flora Rica";"2018";"1615";"802";"813";"98,65";"1392";"223";"86,19";3515806
"Flora Rica";"2019";"1601";"794";"807";"98,39";"1388";"213";"86,7";3515806
"Flora Rica";"2020";"1589";"787";"802";"98,13";"1386";"203";"87,22";3515806
"Floreal";"2016";"2912";"1438";"1474";"97,56";"2430";"482";"83,45";3515905
"Floreal";"2017";"2897";"1428";"1469";"97,21";"2428";"469";"83,81";3515905
"Floreal";"2018";"2884";"1419";"1465";"96,86";"2426";"458";"84,12";3515905
"Floreal";"2019";"2870";"1410";"1460";"96,58";"2423";"447";"84,43";3515905
"Floreal";"2020";"2856";"1401";"1455";"96,29";"2420";"436";"84,73";3515905
"Flórida Paulista";"2016";"12380";"6781";"5599";"121,11";"9768";"2612";"78,9";3516002
"Flórida Paulista";"2017";"12315";"6745";"5570";"121,1";"9716";"2599";"78,9";3516002
"Flórida Paulista";"2018";"12249";"6708";"5541";"121,06";"9664";"2585";"78,9";3516002
"Flórida Paulista";"2019";"12184";"6672";"5512";"121,04";"9613";"2571";"78,9";3516002
"Flórida Paulista";"2020";"12120";"6637";"5483";"121,05";"9563";"2557";"78,9";3516002
"Florínea";"2016";"2740";"1330";"1410";"94,33";"2483";"257";"90,62";3516101
"Florínea";"2017";"2731";"1324";"1407";"94,1";"2482";"249";"90,88";3516101
"Florínea";"2018";"2722";"1319";"1403";"94,01";"2480";"242";"91,11";3516101
"Florínea";"2019";"2713";"1313";"1400";"93,79";"2478";"235";"91,34";3516101
"Florínea";"2020";"2703";"1307";"1396";"93,62";"2475";"228";"91,56";3516101
"Franca";"2016";"333405";"163011";"170394";"95,67";"327552";"5853";"98,24";3516200
"Franca";"2017";"335564";"164058";"171506";"95,66";"329673";"5891";"98,24";3516200
"Franca";"2018";"337738";"165112";"172626";"95,65";"331809";"5929";"98,24";3516200
"Franca";"2019";"339925";"166172";"173753";"95,64";"333957";"5968";"98,24";3516200
"Franca";"2020";"342125";"167238";"174887";"95,63";"336119";"6006";"98,24";3516200
"Francisco Morato";"2016";"166077";"82289";"83788";"98,21";"165739";"338";"99,8";3516309
"Francisco Morato";"2017";"168120";"83284";"84836";"98,17";"167778";"342";"99,8";3516309
"Francisco Morato";"2018";"170189";"84291";"85898";"98,13";"169843";"346";"99,8";3516309
"Francisco Morato";"2019";"172283";"85310";"86973";"98,09";"171933";"350";"99,8";3516309
"Francisco Morato";"2020";"174403";"86341";"88062";"98,05";"174048";"355";"99,8";3516309
"Franco da Rocha";"2016";"144159";"73544";"70615";"104,15";"132811";"11348";"92,13";3516408
"Franco da Rocha";"2017";"146129";"74503";"71626";"104,02";"134626";"11503";"92,13";3516408
"Franco da Rocha";"2018";"148126";"75475";"72651";"103,89";"136465";"11661";"92,13";3516408
"Franco da Rocha";"2019";"150151";"76460";"73691";"103,76";"138331";"11820";"92,13";3516408
"Franco da Rocha";"2020";"152201";"77456";"74745";"103,63";"140219";"11982";"92,13";3516408
"Gabriel Monteiro";"2016";"2698";"1359";"1339";"101,49";"2346";"352";"86,95";3516507
"Gabriel Monteiro";"2017";"2694";"1355";"1339";"101,19";"2356";"338";"87,45";3516507
"Gabriel Monteiro";"2018";"2692";"1352";"1340";"100,9";"2368";"324";"87,96";3516507
"Gabriel Monteiro";"2019";"2688";"1348";"1340";"100,6";"2377";"311";"88,43";3516507
"Gabriel Monteiro";"2020";"2684";"1344";"1340";"100,3";"2386";"298";"88,9";3516507
"Gália";"2016";"6696";"3327";"3369";"98,75";"5114";"1582";"76,37";3516606
"Gália";"2017";"6663";"3307";"3356";"98,54";"5108";"1555";"76,66";3516606
"Gália";"2018";"6629";"3287";"3342";"98,35";"5102";"1527";"76,96";3516606
"Gália";"2019";"6596";"3268";"3328";"98,2";"5095";"1501";"77,24";3516606
"Gália";"2020";"6563";"3248";"3315";"97,98";"5089";"1474";"77,54";3516606
"Garça";"2016";"42712";"20745";"21967";"94,44";"39667";"3045";"92,87";3516705
"Garça";"2017";"42654";"20714";"21940";"94,41";"39714";"2940";"93,11";3516705
"Garça";"2018";"42597";"20683";"21914";"94,38";"39753";"2844";"93,32";3516705
"Garça";"2019";"42540";"20653";"21887";"94,36";"39783";"2757";"93,52";3516705
"Garça";"2020";"42483";"20622";"21861";"94,33";"39806";"2677";"93,7";3516705
"Gastão Vidigal";"2016";"4563";"2487";"2076";"119,8";"4218";"345";"92,44";3516804
"Gastão Vidigal";"2017";"4614";"2512";"2102";"119,51";"4282";"332";"92,8";3516804
"Gastão Vidigal";"2018";"4664";"2537";"2127";"119,28";"4345";"319";"93,16";3516804
"Gastão Vidigal";"2019";"4716";"2562";"2154";"118,94";"4409";"307";"93,49";3516804
"Gastão Vidigal";"2020";"4768";"2588";"2180";"118,72";"4473";"295";"93,81";3516804
"Gavião Peixoto";"2016";"4535";"2332";"2203";"105,86";"3925";"610";"86,55";3516853
"Gavião Peixoto";"2017";"4553";"2339";"2214";"105,65";"3975";"578";"87,31";3516853
"Gavião Peixoto";"2018";"4572";"2347";"2225";"105,48";"4024";"548";"88,01";3516853
"Gavião Peixoto";"2019";"4591";"2354";"2237";"105,23";"4071";"520";"88,67";3516853
"Gavião Peixoto";"2020";"4610";"2362";"2248";"105,07";"4116";"494";"89,28";3516853
"General Salgado";"2016";"10679";"5324";"5355";"99,42";"9319";"1360";"87,26";3516903
"General Salgado";"2017";"10671";"5314";"5357";"99,2";"9347";"1324";"87,59";3516903
"General Salgado";"2018";"10663";"5305";"5358";"99,01";"9373";"1290";"87,9";3516903
"General Salgado";"2019";"10655";"5295";"5360";"98,79";"9399";"1256";"88,21";3516903
"General Salgado";"2020";"10648";"5286";"5362";"98,58";"9424";"1224";"88,5";3516903
"Getulina";"2016";"10807";"5872";"4935";"118,99";"8640";"2167";"79,95";3517000
"Getulina";"2017";"10817";"5876";"4941";"118,92";"8691";"2126";"80,35";3517000
"Getulina";"2018";"10827";"5879";"4948";"118,82";"8742";"2085";"80,74";3517000
"Getulina";"2019";"10837";"5883";"4954";"118,75";"8792";"2045";"81,13";3517000
"Getulina";"2020";"10847";"5887";"4960";"118,69";"8841";"2006";"81,51";3517000
"Glicério";"2016";"4681";"2334";"2347";"99,45";"3545";"1136";"75,73";3517109
"Glicério";"2017";"4698";"2341";"2357";"99,32";"3574";"1124";"76,07";3517109
"Glicério";"2018";"4714";"2347";"2367";"99,16";"3601";"1113";"76,39";3517109
"Glicério";"2019";"4732";"2354";"2378";"98,99";"3631";"1101";"76,73";3517109
"Glicério";"2020";"4749";"2361";"2388";"98,87";"3659";"1090";"77,05";3517109
"Guaimbê";"2016";"5479";"2714";"2765";"98,16";"4921";"558";"89,82";3517307
"Guaimbê";"2017";"5493";"2719";"2774";"98,02";"4954";"539";"90,19";3517307
"Guaimbê";"2018";"5507";"2725";"2782";"97,95";"4985";"522";"90,52";3517307
"Guaimbê";"2019";"5521";"2730";"2791";"97,81";"5016";"505";"90,85";3517307
"Guaimbê";"2020";"5534";"2735";"2799";"97,71";"5045";"489";"91,16";3517307
"Guaíra";"2016";"38473";"18993";"19480";"97,5";"37235";"1238";"96,78";3517406
"Guaíra";"2017";"38619";"19056";"19563";"97,41";"37388";"1231";"96,81";3517406
"Guaíra";"2018";"38766";"19120";"19646";"97,32";"37540";"1226";"96,84";3517406
"Guaíra";"2019";"38913";"19183";"19730";"97,23";"37690";"1223";"96,86";3517406
"Guaíra";"2020";"39061";"19247";"19814";"97,14";"37840";"1221";"96,87";3517406
"Guaiçara";"2016";"11454";"5743";"5711";"100,56";"10576";"878";"92,33";3517208
"Guaiçara";"2017";"11576";"5802";"5774";"100,48";"10714";"862";"92,55";3517208
"Guaiçara";"2018";"11698";"5861";"5837";"100,41";"10852";"846";"92,77";3517208
"Guaiçara";"2019";"11822";"5921";"5901";"100,34";"10991";"831";"92,97";3517208
"Guaiçara";"2020";"11947";"5981";"5966";"100,25";"11131";"816";"93,17";3517208
"Guapiara";"2016";"17707";"8969";"8738";"102,64";"7328";"10379";"41,38";3517604
"Guapiara";"2017";"17724";"8973";"8751";"102,54";"7371";"10353";"41,59";3517604
"Guapiara";"2018";"17741";"8976";"8765";"102,41";"7413";"10328";"41,78";3517604
"Guapiara";"2019";"17758";"8980";"8778";"102,3";"7456";"10302";"41,99";3517604
"Guapiara";"2020";"17775";"8983";"8792";"102,17";"7499";"10276";"42,19";3517604
"Guapiaçu";"2016";"19753";"9951";"9802";"101,52";"17788";"1965";"90,05";3517505
"Guapiaçu";"2017";"20021";"10081";"9940";"101,42";"18073";"1948";"90,27";3517505
"Guapiaçu";"2018";"20293";"10213";"10080";"101,32";"18360";"1933";"90,47";3517505
"Guapiaçu";"2019";"20569";"10347";"10222";"101,22";"18650";"1919";"90,67";3517505
"Guapiaçu";"2020";"20848";"10482";"10366";"101,12";"18942";"1906";"90,86";3517505
"Guará";"2016";"20421";"10145";"10276";"98,73";"19884";"537";"97,37";3517703
"Guará";"2017";"20521";"10192";"10329";"98,67";"19996";"525";"97,44";3517703
"Guará";"2018";"20622";"10240";"10382";"98,63";"20108";"514";"97,51";3517703
"Guará";"2019";"20722";"10287";"10435";"98,58";"20218";"504";"97,57";3517703
"Guará";"2020";"20824";"10335";"10489";"98,53";"20329";"495";"97,62";3517703
"Guaraci";"2016";"10589";"5379";"5210";"103,24";"9718";"871";"91,77";3517901
"Guaraci";"2017";"10685";"5425";"5260";"103,14";"9840";"845";"92,09";3517901
"Guaraci";"2018";"10781";"5471";"5310";"103,03";"9960";"821";"92,38";3517901
"Guaraci";"2019";"10879";"5518";"5361";"102,93";"10080";"799";"92,66";3517901
"Guaraci";"2020";"10978";"5565";"5413";"102,81";"10201";"777";"92,92";3517901
"Guarani d'Oeste";"2016";"1942";"949";"993";"95,57";"1726";"216";"88,88";3518008
"Guarani d'Oeste";"2017";"1937";"946";"991";"95,46";"1724";"213";"89";3518008
"Guarani d'Oeste";"2018";"1932";"944";"988";"95,55";"1722";"210";"89,13";3518008
"Guarani d'Oeste";"2019";"1927";"941";"986";"95,44";"1720";"207";"89,26";3518008
"Guarani d'Oeste";"2020";"1922";"939";"983";"95,52";"1718";"204";"89,39";3518008
"Guarantã";"2016";"6445";"3233";"3212";"100,65";"5731";"714";"88,92";3518107
"Guarantã";"2017";"6452";"3235";"3217";"100,56";"5770";"682";"89,43";3518107
"Guarantã";"2018";"6461";"3238";"3223";"100,47";"5810";"651";"89,92";3518107
"Guarantã";"2019";"6468";"3240";"3228";"100,37";"5846";"622";"90,38";3518107
"Guarantã";"2020";"6477";"3243";"3234";"100,28";"5882";"595";"90,81";3518107
"Guararapes";"2016";"31570";"15504";"16066";"96,5";"29513";"2057";"93,48";3518206
"Guararapes";"2017";"31696";"15559";"16137";"96,42";"29675";"2021";"93,62";3518206
"Guararapes";"2018";"31822";"15614";"16208";"96,34";"29836";"1986";"93,76";3518206
"Guararapes";"2019";"31949";"15669";"16280";"96,25";"29997";"1952";"93,89";3518206
"Guararapes";"2020";"32076";"15724";"16352";"96,16";"30158";"1918";"94,02";3518206
"Guararema";"2016";"27973";"14005";"13968";"100,26";"24072";"3901";"86,05";3518305
"Guararema";"2017";"28330";"14174";"14156";"100,13";"24379";"3951";"86,05";3518305
"Guararema";"2018";"28692";"14345";"14347";"99,99";"24691";"4001";"86,06";3518305
"Guararema";"2019";"29058";"14519";"14539";"99,86";"25006";"4052";"86,06";3518305
"Guararema";"2020";"29429";"14694";"14735";"99,72";"25325";"4104";"86,05";3518305
"Guaratinguetá";"2016";"116020";"55815";"60205";"92,71";"110600";"5420";"95,33";3518404
"Guaratinguetá";"2017";"116597";"56088";"60509";"92,69";"111163";"5434";"95,34";3518404
"Guaratinguetá";"2018";"117177";"56362";"60815";"92,68";"111728";"5449";"95,35";3518404
"Guaratinguetá";"2019";"117760";"56638";"61122";"92,66";"112297";"5463";"95,36";3518404
"Guaratinguetá";"2020";"118345";"56915";"61430";"92,65";"112868";"5477";"95,37";3518404
"Guaraçaí";"2016";"8434";"4163";"4271";"97,47";"6823";"1611";"80,9";3517802
"Guaraçaí";"2017";"8428";"4157";"4271";"97,33";"6845";"1583";"81,22";3517802
"Guaraçaí";"2018";"8424";"4152";"4272";"97,19";"6868";"1556";"81,53";3517802
"Guaraçaí";"2019";"8418";"4146";"4272";"97,05";"6890";"1528";"81,85";3517802
"Guaraçaí";"2020";"8412";"4140";"4272";"96,91";"6910";"1502";"82,14";3517802
"Guareí";"2016";"15279";"9234";"6045";"152,75";"8825";"6454";"57,76";3518503
"Guareí";"2017";"15395";"9287";"6108";"152,05";"8892";"6503";"57,76";3518503
"Guareí";"2018";"15512";"9340";"6172";"151,33";"8960";"6552";"57,76";3518503
"Guareí";"2019";"15631";"9394";"6237";"150,62";"9029";"6602";"57,76";3518503
"Guareí";"2020";"15750";"9448";"6302";"149,92";"9097";"6653";"57,76";3518503
"Guariba";"2016";"37679";"18934";"18745";"101,01";"37016";"663";"98,24";3518602
"Guariba";"2017";"38010";"19089";"18921";"100,89";"37360";"650";"98,29";3518602
"Guariba";"2018";"38344";"19246";"19098";"100,77";"37706";"638";"98,34";3518602
"Guariba";"2019";"38681";"19404";"19277";"100,66";"38054";"627";"98,38";3518602
"Guariba";"2020";"39021";"19563";"19458";"100,54";"38406";"615";"98,42";3518602
"Guarujá";"2016";"305938";"149056";"156882";"95,01";"305879";"59";"99,98";3518701
"Guarujá";"2017";"308522";"150310";"158212";"95,01";"308463";"59";"99,98";3518701
"Guarujá";"2018";"311128";"151574";"159554";"95";"311068";"60";"99,98";3518701
"Guarujá";"2019";"313756";"152849";"160907";"94,99";"313696";"60";"99,98";3518701
"Guarujá";"2020";"316405";"154134";"162271";"94,99";"316344";"61";"99,98";3518701
"Guarulhos";"2016";"1300708";"633646";"667062";"94,99";"1300708";"-";"100";3518800
"Guarulhos";"2017";"1313169";"639737";"673432";"95";"1313169";"-";"100";3518800
"Guarulhos";"2018";"1325750";"645886";"679864";"95";"1325750";"-";"100";3518800
"Guarulhos";"2019";"1338452";"652095";"686357";"95,01";"1338452";"-";"100";3518800
"Guarulhos";"2020";"1351275";"658363";"692912";"95,01";"1351275";"-";"100";3518800
"Guatapará";"2016";"7250";"3705";"3545";"104,51";"5641";"1609";"77,81";3518859
"Guatapará";"2017";"7297";"3725";"3572";"104,28";"5727";"1570";"78,48";3518859
"Guatapará";"2018";"7345";"3746";"3599";"104,08";"5813";"1532";"79,14";3518859
"Guatapará";"2019";"7392";"3766";"3626";"103,86";"5897";"1495";"79,78";3518859
"Guatapará";"2020";"7440";"3787";"3653";"103,67";"5982";"1458";"80,4";3518859
"Guzolândia";"2016";"4970";"2523";"2447";"103,11";"4347";"623";"87,46";3518909
"Guzolândia";"2017";"5004";"2537";"2467";"102,84";"4398";"606";"87,89";3518909
"Guzolândia";"2018";"5038";"2551";"2487";"102,57";"4449";"589";"88,31";3518909
"Guzolândia";"2019";"5072";"2565";"2507";"102,31";"4499";"573";"88,7";3518909
"Guzolândia";"2020";"5107";"2579";"2528";"102,02";"4550";"557";"89,09";3518909
"Herculândia";"2016";"9036";"4513";"4523";"99,78";"8391";"645";"92,86";3519006
"Herculândia";"2017";"9091";"4540";"4551";"99,76";"8462";"629";"93,08";3519006
"Herculândia";"2018";"9147";"4567";"4580";"99,72";"8533";"614";"93,29";3519006
"Herculândia";"2019";"9204";"4594";"4610";"99,65";"8603";"601";"93,47";3519006
"Herculândia";"2020";"9260";"4621";"4639";"99,61";"8671";"589";"93,64";3519006
"Holambra";"2016";"13335";"6748";"6587";"102,44";"10743";"2592";"80,56";3519055
"Holambra";"2017";"13616";"6889";"6727";"102,41";"11125";"2491";"81,71";3519055
"Holambra";"2018";"13901";"7032";"6869";"102,37";"11508";"2393";"82,79";3519055
"Holambra";"2019";"14194";"7179";"7015";"102,34";"11896";"2298";"83,81";3519055
"Holambra";"2020";"14493";"7329";"7164";"102,3";"12287";"2206";"84,78";3519055
"Hortolândia";"2016";"215281";"108423";"106858";"101,46";"215281";"-";"100";3519071
"Hortolândia";"2017";"218934";"110199";"108735";"101,35";"218934";"-";"100";3519071
"Hortolândia";"2018";"222649";"112004";"110645";"101,23";"222649";"-";"100";3519071
"Hortolândia";"2019";"226426";"113838";"112588";"101,11";"226426";"-";"100";3519071
"Hortolândia";"2020";"230268";"115703";"114565";"100,99";"230268";"-";"100";3519071
"Iacanga";"2016";"10820";"5550";"5270";"105,31";"9531";"1289";"88,09";3519105
"Iacanga";"2017";"10939";"5607";"5332";"105,16";"9652";"1287";"88,23";3519105
"Iacanga";"2018";"11060";"5665";"5395";"105";"9775";"1285";"88,38";3519105
"Iacanga";"2019";"11182";"5723";"5459";"104,84";"9899";"1283";"88,53";3519105
"Iacanga";"2020";"11306";"5782";"5524";"104,67";"10025";"1281";"88,67";3519105
"Iacri";"2016";"6337";"3203";"3134";"102,2";"5222";"1115";"82,4";3519204
"Iacri";"2017";"6320";"3194";"3126";"102,18";"5243";"1077";"82,96";3519204
"Iacri";"2018";"6305";"3186";"3119";"102,15";"5264";"1041";"83,49";3519204
"Iacri";"2019";"6288";"3177";"3111";"102,12";"5282";"1006";"84";3519204
"Iacri";"2020";"6272";"3168";"3104";"102,06";"5299";"973";"84,49";3519204
"Iaras";"2016";"6677";"4330";"2347";"184,49";"2971";"3706";"44,5";3519253
"Iaras";"2017";"6731";"4356";"2375";"183,41";"2995";"3736";"44,5";3519253
"Iaras";"2018";"6785";"4382";"2403";"182,36";"3019";"3766";"44,5";3519253
"Iaras";"2019";"6839";"4408";"2431";"181,32";"3043";"3796";"44,49";3519253
"Iaras";"2020";"6894";"4434";"2460";"180,24";"3067";"3827";"44,49";3519253
"Ibaté";"2016";"33192";"16976";"16216";"104,69";"31996";"1196";"96,4";3519303
"Ibaté";"2017";"33572";"17156";"16416";"104,51";"32379";"1193";"96,45";3519303
"Ibaté";"2018";"33956";"17338";"16618";"104,33";"32765";"1191";"96,49";3519303
"Ibaté";"2019";"34345";"17523";"16822";"104,17";"33156";"1189";"96,54";3519303
"Ibaté";"2020";"34738";"17709";"17029";"103,99";"33550";"1188";"96,58";3519303
"Ibirá";"2016";"11627";"5759";"5868";"98,14";"10827";"800";"93,12";3519402
"Ibirá";"2017";"11733";"5809";"5924";"98,06";"10937";"796";"93,22";3519402
"Ibirá";"2018";"11841";"5860";"5981";"97,98";"11048";"793";"93,3";3519402
"Ibirá";"2019";"11949";"5911";"6038";"97,9";"11158";"791";"93,38";3519402
"Ibirá";"2020";"12059";"5963";"6096";"97,82";"11269";"790";"93,45";3519402
"Ibirarema";"2016";"7197";"3613";"3584";"100,81";"6725";"472";"93,44";3519501
"Ibirarema";"2017";"7274";"3649";"3625";"100,66";"6807";"467";"93,58";3519501
"Ibirarema";"2018";"7351";"3685";"3666";"100,52";"6888";"463";"93,7";3519501
"Ibirarema";"2019";"7430";"3722";"3708";"100,38";"6971";"459";"93,82";3519501
"Ibirarema";"2020";"7509";"3759";"3750";"100,24";"7054";"455";"93,94";3519501
"Ibitinga";"2016";"56538";"27825";"28713";"96,91";"54593";"1945";"96,56";3519600
"Ibitinga";"2017";"57022";"28056";"28966";"96,86";"55094";"1928";"96,62";3519600
"Ibitinga";"2018";"57511";"28289";"29222";"96,81";"55597";"1914";"96,67";3519600
"Ibitinga";"2019";"58003";"28523";"29480";"96,75";"56100";"1903";"96,72";3519600
"Ibitinga";"2020";"58501";"28760";"29741";"96,7";"56607";"1894";"96,76";3519600
"Ibiúna";"2016";"74364";"37600";"36764";"102,27";"26872";"47492";"36,14";3519709
"Ibiúna";"2017";"74875";"37828";"37047";"102,11";"27198";"47677";"36,32";3519709
"Ibiúna";"2018";"75390";"38057";"37333";"101,94";"27528";"47862";"36,51";3519709
"Ibiúna";"2019";"75908";"38288";"37620";"101,78";"27862";"48046";"36,7";3519709
"Ibiúna";"2020";"76430";"38520";"37910";"101,61";"28199";"48231";"36,9";3519709
"Icém";"2016";"7814";"3967";"3847";"103,12";"6747";"1067";"86,35";3519808
"Icém";"2017";"7867";"3993";"3874";"103,07";"6800";"1067";"86,44";3519808
"Icém";"2018";"7922";"4020";"3902";"103,02";"6854";"1068";"86,52";3519808
"Icém";"2019";"7977";"4048";"3929";"103,03";"6908";"1069";"86,6";3519808
"Icém";"2020";"8032";"4075";"3957";"102,98";"6963";"1069";"86,69";3519808
"Iepê";"2016";"7799";"3840";"3959";"96,99";"7134";"665";"91,47";3519907
"Iepê";"2017";"7828";"3851";"3977";"96,83";"7189";"639";"91,84";3519907
"Iepê";"2018";"7859";"3863";"3996";"96,67";"7245";"614";"92,19";3519907
"Iepê";"2019";"7890";"3875";"4015";"96,51";"7300";"590";"92,52";3519907
"Iepê";"2020";"7921";"3887";"4034";"96,36";"7354";"567";"92,84";3519907
"Igarapava";"2016";"28899";"14282";"14617";"97,71";"27467";"1432";"95,04";3520103
"Igarapava";"2017";"29037";"14348";"14689";"97,68";"27630";"1407";"95,15";3520103
"Igarapava";"2018";"29176";"14415";"14761";"97,66";"27793";"1383";"95,26";3520103
"Igarapava";"2019";"29316";"14482";"14834";"97,63";"27956";"1360";"95,36";3520103
"Igarapava";"2020";"29456";"14549";"14907";"97,6";"28119";"1337";"95,46";3520103
"Igaratá";"2016";"9122";"4649";"4473";"103,93";"7602";"1520";"83,34";3520202
"Igaratá";"2017";"9169";"4669";"4500";"103,76";"7696";"1473";"83,93";3520202
"Igaratá";"2018";"9217";"4689";"4528";"103,56";"7789";"1428";"84,51";3520202
"Igaratá";"2019";"9264";"4709";"4555";"103,38";"7880";"1384";"85,06";3520202
"Igaratá";"2020";"9312";"4729";"4583";"103,19";"7971";"1341";"85,6";3520202
"Igaraçu do Tietê";"2016";"23817";"11841";"11976";"98,87";"23680";"137";"99,42";3520004
"Igaraçu do Tietê";"2017";"23897";"11875";"12022";"98,78";"23760";"137";"99,43";3520004
"Igaraçu do Tietê";"2018";"23976";"11909";"12067";"98,69";"23838";"138";"99,42";3520004
"Igaraçu do Tietê";"2019";"24055";"11942";"12113";"98,59";"23917";"138";"99,43";3520004
"Igaraçu do Tietê";"2020";"24135";"11976";"12159";"98,49";"23997";"138";"99,43";3520004
"Iguape";"2016";"29158";"14532";"14626";"99,36";"25394";"3764";"87,09";3520301
"Iguape";"2017";"29235";"14557";"14678";"99,18";"25511";"3724";"87,26";3520301
"Iguape";"2018";"29311";"14582";"14729";"99";"25622";"3689";"87,41";3520301
"Iguape";"2019";"29388";"14607";"14781";"98,82";"25730";"3658";"87,55";3520301
"Iguape";"2020";"29465";"14632";"14833";"98,64";"25834";"3631";"87,68";3520301
"Ilha Comprida";"2016";"9774";"4788";"4986";"96,03";"9774";"-";"100";3520426
"Ilha Comprida";"2017";"9901";"4842";"5059";"95,71";"9901";"-";"100";3520426
"Ilha Comprida";"2018";"10031";"4897";"5134";"95,38";"10031";"-";"100";3520426
"Ilha Comprida";"2019";"10163";"4953";"5210";"95,07";"10163";"-";"100";3520426
"Ilha Comprida";"2020";"10296";"5009";"5287";"94,74";"10296";"-";"100";3520426
"Ilha Solteira";"2016";"25539";"12367";"13172";"93,89";"23966";"1573";"93,84";3520442
"Ilha Solteira";"2017";"25591";"12382";"13209";"93,74";"24015";"1576";"93,84";3520442
"Ilha Solteira";"2018";"25643";"12396";"13247";"93,58";"24063";"1580";"93,84";3520442
"Ilha Solteira";"2019";"25695";"12411";"13284";"93,43";"24112";"1583";"93,84";3520442
"Ilha Solteira";"2020";"25748";"12426";"13322";"93,27";"24162";"1586";"93,84";3520442
"Ilhabela";"2016";"31508";"15926";"15582";"102,21";"31291";"217";"99,31";3520400
"Ilhabela";"2017";"31988";"16156";"15832";"102,05";"31768";"220";"99,31";3520400
"Ilhabela";"2018";"32474";"16388";"16086";"101,88";"32251";"223";"99,31";3520400
"Ilhabela";"2019";"32968";"16624";"16344";"101,71";"32741";"227";"99,31";3520400
"Ilhabela";"2020";"33470";"16864";"16606";"101,55";"33240";"230";"99,31";3520400
"Indaiatuba";"2016";"229256";"113648";"115608";"98,3";"226951";"2305";"98,99";3520509
"Indaiatuba";"2017";"232586";"115258";"117328";"98,24";"230248";"2338";"98,99";3520509
"Indaiatuba";"2018";"235964";"116891";"119073";"98,17";"233592";"2372";"98,99";3520509
"Indaiatuba";"2019";"239391";"118547";"120844";"98,1";"236984";"2407";"98,99";3520509
"Indaiatuba";"2020";"242868";"120227";"122641";"98,03";"240426";"2442";"98,99";3520509
"Indiana";"2016";"4796";"2401";"2395";"100,25";"4181";"615";"87,18";3520608
"Indiana";"2017";"4791";"2398";"2393";"100,21";"4188";"603";"87,41";3520608
"Indiana";"2018";"4785";"2394";"2391";"100,13";"4195";"590";"87,67";3520608
"Indiana";"2019";"4780";"2391";"2389";"100,08";"4202";"578";"87,91";3520608
"Indiana";"2020";"4775";"2388";"2387";"100,04";"4209";"566";"88,15";3520608
"Indiaporã";"2016";"3866";"1885";"1981";"95,15";"3453";"413";"89,32";3520707
"Indiaporã";"2017";"3863";"1880";"1983";"94,81";"3464";"399";"89,67";3520707
"Indiaporã";"2018";"3860";"1876";"1984";"94,56";"3474";"386";"90";3520707
"Indiaporã";"2019";"3857";"1871";"1986";"94,21";"3483";"374";"90,3";3520707
"Indiaporã";"2020";"3854";"1867";"1987";"93,96";"3491";"363";"90,58";3520707
"Inúbia Paulista";"2016";"3793";"1893";"1900";"99,63";"3395";"398";"89,51";3520806
"Inúbia Paulista";"2017";"3818";"1904";"1914";"99,48";"3429";"389";"89,81";3520806
"Inúbia Paulista";"2018";"3842";"1915";"1927";"99,38";"3461";"381";"90,08";3520806
"Inúbia Paulista";"2019";"3867";"1927";"1940";"99,33";"3494";"373";"90,35";3520806
"Inúbia Paulista";"2020";"3892";"1938";"1954";"99,18";"3527";"365";"90,62";3520806
"Ipaussu";"2016";"14163";"7118";"7045";"101,04";"13238";"925";"93,47";3520905
"Ipaussu";"2017";"14247";"7157";"7090";"100,94";"13340";"907";"93,63";3520905
"Ipaussu";"2018";"14333";"7197";"7136";"100,85";"13443";"890";"93,79";3520905
"Ipaussu";"2019";"14420";"7238";"7182";"100,78";"13544";"876";"93,93";3520905
"Ipaussu";"2020";"14506";"7278";"7228";"100,69";"13644";"862";"94,06";3520905
"Iperó";"2016";"32077";"17065";"15012";"113,68";"19794";"12283";"61,71";3521002
"Iperó";"2017";"32632";"17337";"15295";"113,35";"20136";"12496";"61,71";3521002
"Iperó";"2018";"33195";"17612";"15583";"113,02";"20484";"12711";"61,71";3521002
"Iperó";"2019";"33769";"17892";"15877";"112,69";"20838";"12931";"61,71";3521002
"Iperó";"2020";"34352";"18176";"16176";"112,36";"21197";"13155";"61,71";3521002
"Ipeúna";"2016";"6932";"3566";"3366";"105,94";"6171";"761";"89,02";3521101
"Ipeúna";"2017";"7087";"3642";"3445";"105,72";"6339";"748";"89,45";3521101
"Ipeúna";"2018";"7244";"3719";"3525";"105,5";"6509";"735";"89,85";3521101
"Ipeúna";"2019";"7406";"3798";"3608";"105,27";"6683";"723";"90,24";3521101
"Ipeúna";"2020";"7571";"3879";"3692";"105,07";"6860";"711";"90,61";3521101
"Ipiguá";"2016";"4940";"2493";"2447";"101,88";"3113";"1827";"63,02";3521150
"Ipiguá";"2017";"5011";"2527";"2484";"101,73";"3179";"1832";"63,44";3521150
"Ipiguá";"2018";"5083";"2561";"2522";"101,55";"3246";"1837";"63,86";3521150
"Ipiguá";"2019";"5157";"2596";"2561";"101,37";"3314";"1843";"64,26";3521150
"Ipiguá";"2020";"5231";"2631";"2600";"101,19";"3383";"1848";"64,67";3521150
"Iporanga";"2016";"4353";"2186";"2167";"100,88";"2692";"1661";"61,84";3521200
"Iporanga";"2017";"4366";"2191";"2175";"100,74";"2743";"1623";"62,83";3521200
"Iporanga";"2018";"4380";"2196";"2184";"100,55";"2793";"1587";"63,77";3521200
"Iporanga";"2019";"4393";"2201";"2192";"100,41";"2843";"1550";"64,72";3521200
"Iporanga";"2020";"4407";"2206";"2201";"100,23";"2894";"1513";"65,67";3521200
"Ipuã";"2016";"15197";"7709";"7488";"102,95";"14663";"534";"96,49";3521309
"Ipuã";"2017";"15360";"7786";"7574";"102,8";"14834";"526";"96,58";3521309
"Ipuã";"2018";"15526";"7864";"7662";"102,64";"15007";"519";"96,66";3521309
"Ipuã";"2019";"15693";"7943";"7750";"102,49";"15181";"512";"96,74";3521309
"Ipuã";"2020";"15861";"8022";"7839";"102,33";"15355";"506";"96,81";3521309
"Iracemápolis";"2016";"22331";"11155";"11176";"99,81";"21927";"404";"98,19";3521408
"Iracemápolis";"2017";"22655";"11310";"11345";"99,69";"22249";"406";"98,21";3521408
"Iracemápolis";"2018";"22982";"11466";"11516";"99,57";"22573";"409";"98,22";3521408
"Iracemápolis";"2019";"23316";"11626";"11690";"99,45";"22904";"412";"98,23";3521408
"Iracemápolis";"2020";"23654";"11787";"11867";"99,33";"23238";"416";"98,24";3521408
"Irapuã";"2016";"7560";"3932";"3628";"108,38";"6906";"654";"91,35";3521507
"Irapuã";"2017";"7604";"3952";"3652";"108,21";"6965";"639";"91,6";3521507
"Irapuã";"2018";"7647";"3971";"3676";"108,03";"7022";"625";"91,83";3521507
"Irapuã";"2019";"7690";"3990";"3700";"107,84";"7078";"612";"92,04";3521507
"Irapuã";"2020";"7734";"4010";"3724";"107,68";"7132";"602";"92,22";3521507
"Irapuru";"2016";"7502";"4354";"3148";"138,31";"5304";"2198";"70,7";3521606
"Irapuru";"2017";"7460";"4329";"3131";"138,26";"5274";"2186";"70,7";3521606
"Irapuru";"2018";"7419";"4305";"3114";"138,25";"5245";"2174";"70,7";3521606
"Irapuru";"2019";"7376";"4280";"3096";"138,24";"5215";"2161";"70,7";3521606
"Irapuru";"2020";"7334";"4255";"3079";"138,19";"5185";"2149";"70,7";3521606
"Itaberá";"2016";"17665";"8882";"8783";"101,13";"12885";"4780";"72,94";3521705
"Itaberá";"2017";"17653";"8871";"8782";"101,01";"13014";"4639";"73,72";3521705
"Itaberá";"2018";"17639";"8859";"8780";"100,9";"13138";"4501";"74,48";3521705
"Itaberá";"2019";"17627";"8848";"8779";"100,79";"13260";"4367";"75,23";3521705
"Itaberá";"2020";"17614";"8836";"8778";"100,66";"13379";"4235";"75,96";3521705
"Itaí";"2016";"25505";"13453";"12052";"111,62";"20028";"5477";"78,53";3521804
"Itaí";"2017";"25753";"13571";"12182";"111,4";"20222";"5531";"78,52";3521804
"Itaí";"2018";"26002";"13689";"12313";"111,18";"20418";"5584";"78,52";3521804
"Itaí";"2019";"26254";"13809";"12445";"110,96";"20616";"5638";"78,53";3521804
"Itaí";"2020";"26507";"13928";"12579";"110,72";"20814";"5693";"78,52";3521804
"Itajobi";"2016";"14619";"7336";"7283";"100,73";"12622";"1997";"86,34";3521903
"Itajobi";"2017";"14618";"7329";"7289";"100,55";"12681";"1937";"86,75";3521903
"Itajobi";"2018";"14616";"7322";"7294";"100,38";"12736";"1880";"87,14";3521903
"Itajobi";"2019";"14615";"7315";"7300";"100,21";"12789";"1826";"87,51";3521903
"Itajobi";"2020";"14614";"7308";"7306";"100,03";"12840";"1774";"87,86";3521903
"Itaju";"2016";"3502";"1822";"1680";"108,45";"2730";"772";"77,96";3522000
"Itaju";"2017";"3539";"1839";"1700";"108,18";"2787";"752";"78,75";3522000
"Itaju";"2018";"3577";"1856";"1721";"107,84";"2844";"733";"79,51";3522000
"Itaju";"2019";"3615";"1873";"1742";"107,52";"2901";"714";"80,25";3522000
"Itaju";"2020";"3654";"1891";"1763";"107,26";"2959";"695";"80,98";3522000
"Itanhaém";"2016";"94088";"45395";"48693";"93,23";"93319";"769";"99,18";3522109
"Itanhaém";"2017";"95235";"45926";"49309";"93,14";"94473";"762";"99,2";3522109
"Itanhaém";"2018";"96394";"46462";"49932";"93,05";"95640";"754";"99,22";3522109
"Itanhaém";"2019";"97569";"47005";"50564";"92,96";"96823";"746";"99,24";3522109
"Itanhaém";"2020";"98757";"47554";"51203";"92,87";"98018";"739";"99,25";3522109
"Itaoca";"2016";"3186";"1658";"1528";"108,51";"1737";"1449";"54,52";3522158
"Itaoca";"2017";"3186";"1656";"1530";"108,24";"1737";"1449";"54,52";3522158
"Itaoca";"2018";"3186";"1655";"1531";"108,1";"1737";"1449";"54,52";3522158
"Itaoca";"2019";"3186";"1653";"1533";"107,83";"1737";"1449";"54,52";3522158
"Itaoca";"2020";"3186";"1652";"1534";"107,69";"1737";"1449";"54,52";3522158
"Itapecerica da Serra";"2016";"162907";"81305";"81602";"99,64";"161557";"1350";"99,17";3522208
"Itapecerica da Serra";"2017";"164559";"82112";"82447";"99,59";"163195";"1364";"99,17";3522208
"Itapecerica da Serra";"2018";"166229";"82927";"83302";"99,55";"164851";"1378";"99,17";3522208
"Itapecerica da Serra";"2019";"167916";"83751";"84165";"99,51";"166524";"1392";"99,17";3522208
"Itapecerica da Serra";"2020";"169619";"84582";"85037";"99,46";"168213";"1406";"99,17";3522208
"Itapetininga";"2016";"153861";"76683";"77178";"99,36";"140853";"13008";"91,55";3522307
"Itapetininga";"2017";"155410";"77431";"77979";"99,3";"142462";"12948";"91,67";3522307
"Itapetininga";"2018";"156973";"78186";"78787";"99,24";"144084";"12889";"91,79";3522307
"Itapetininga";"2019";"158553";"78949";"79604";"99,18";"145723";"12830";"91,91";3522307
"Itapetininga";"2020";"160150";"79719";"80431";"99,11";"147379";"12771";"92,03";3522307
"Itapeva";"2016";"89992";"44335";"45657";"97,1";"79833";"10159";"88,71";3522406
"Itapeva";"2017";"90414";"44542";"45872";"97,1";"80761";"9653";"89,32";3522406
"Itapeva";"2018";"90839";"44751";"46088";"97,1";"81668";"9171";"89,9";3522406
"Itapeva";"2019";"91265";"44960";"46305";"97,1";"82551";"8714";"90,45";3522406
"Itapeva";"2020";"91693";"45170";"46523";"97,09";"83413";"8280";"90,97";3522406
"Itapevi";"2016";"222501";"109432";"113069";"96,78";"222501";"-";"100";3522505
"Itapevi";"2017";"226211";"111256";"114955";"96,78";"226211";"-";"100";3522505
"Itapevi";"2018";"229982";"113109";"116873";"96,78";"229982";"-";"100";3522505
"Itapevi";"2019";"233816";"114994";"118822";"96,78";"233816";"-";"100";3522505
"Itapevi";"2020";"237714";"116910";"120804";"96,78";"237714";"-";"100";3522505
"Itapira";"2016";"70571";"34846";"35725";"97,54";"65894";"4677";"93,37";3522604
"Itapira";"2017";"70802";"34942";"35860";"97,44";"66177";"4625";"93,47";3522604
"Itapira";"2018";"71034";"35038";"35996";"97,34";"66461";"4573";"93,56";3522604
"Itapira";"2019";"71266";"35134";"36132";"97,24";"66743";"4523";"93,65";3522604
"Itapira";"2020";"71500";"35231";"36269";"97,14";"67027";"4473";"93,74";3522604
"Itapirapuã Paulista";"2016";"4040";"2065";"1975";"104,56";"2033";"2007";"50,32";3522653
"Itapirapuã Paulista";"2017";"4075";"2080";"1995";"104,26";"2061";"2014";"50,58";3522653
"Itapirapuã Paulista";"2018";"4109";"2094";"2015";"103,92";"2089";"2020";"50,84";3522653
"Itapirapuã Paulista";"2019";"4144";"2109";"2035";"103,64";"2117";"2027";"51,09";3522653
"Itapirapuã Paulista";"2020";"4180";"2124";"2056";"103,31";"2146";"2034";"51,34";3522653
"Itápolis";"2016";"40978";"20257";"20721";"97,76";"38017";"2961";"92,77";3522703
"Itápolis";"2017";"41120";"20316";"20804";"97,65";"38263";"2857";"93,05";3522703
"Itápolis";"2018";"41262";"20375";"20887";"97,55";"38502";"2760";"93,31";3522703
"Itápolis";"2019";"41405";"20434";"20971";"97,44";"38737";"2668";"93,56";3522703
"Itápolis";"2020";"41548";"20493";"21055";"97,33";"38966";"2582";"93,79";3522703
"Itaporanga";"2016";"14617";"7278";"7339";"99,17";"11590";"3027";"79,29";3522802
"Itaporanga";"2017";"14635";"7284";"7351";"99,09";"11683";"2952";"79,83";3522802
"Itaporanga";"2018";"14653";"7289";"7364";"98,98";"11775";"2878";"80,36";3522802
"Itaporanga";"2019";"14671";"7295";"7376";"98,9";"11865";"2806";"80,87";3522802
"Itaporanga";"2020";"14688";"7300";"7388";"98,81";"11952";"2736";"81,37";3522802
"Itapuí";"2016";"13163";"6618";"6545";"101,12";"12710";"453";"96,56";3522901
"Itapuí";"2017";"13314";"6688";"6626";"100,94";"12873";"441";"96,69";3522901
"Itapuí";"2018";"13467";"6759";"6708";"100,76";"13038";"429";"96,81";3522901
"Itapuí";"2019";"13622";"6831";"6791";"100,59";"13203";"419";"96,92";3522901
"Itapuí";"2020";"13779";"6904";"6875";"100,42";"13369";"410";"97,02";3522901
"Itapura";"2016";"4694";"2411";"2283";"105,61";"3751";"943";"79,91";3523008
"Itapura";"2017";"4748";"2435";"2313";"105,27";"3794";"954";"79,91";3523008
"Itapura";"2018";"4804";"2460";"2344";"104,95";"3839";"965";"79,91";3523008
"Itapura";"2019";"4860";"2485";"2375";"104,63";"3884";"976";"79,92";3523008
"Itapura";"2020";"4916";"2510";"2406";"104,32";"3929";"987";"79,92";3523008
"Itaquaquecetuba";"2016";"350610";"172561";"178049";"96,92";"350610";"-";"100";3523107
"Itaquaquecetuba";"2017";"355502";"174935";"180567";"96,88";"355502";"-";"100";3523107
"Itaquaquecetuba";"2018";"360462";"177342";"183120";"96,84";"360462";"-";"100";3523107
"Itaquaquecetuba";"2019";"365490";"179781";"185709";"96,81";"365490";"-";"100";3523107
"Itaquaquecetuba";"2020";"370589";"182254";"188335";"96,77";"370589";"-";"100";3523107
"Itararé";"2016";"48504";"23775";"24729";"96,14";"44910";"3594";"92,59";3523206
"Itararé";"2017";"48633";"23834";"24799";"96,11";"45048";"3585";"92,63";3523206
"Itararé";"2018";"48760";"23892";"24868";"96,08";"45184";"3576";"92,67";3523206
"Itararé";"2019";"48889";"23951";"24938";"96,04";"45322";"3567";"92,7";3523206
"Itararé";"2020";"49018";"24010";"25008";"96,01";"45460";"3558";"92,74";3523206
"Itariri";"2016";"16538";"8294";"8244";"100,61";"11340";"5198";"68,57";3523305
"Itariri";"2017";"16720";"8379";"8341";"100,46";"11585";"5135";"69,29";3523305
"Itariri";"2018";"16902";"8464";"8438";"100,31";"11830";"5072";"69,99";3523305
"Itariri";"2019";"17087";"8550";"8537";"100,15";"12076";"5011";"70,67";3523305
"Itariri";"2020";"17274";"8637";"8637";"100";"12323";"4951";"71,34";3523305
"Itatiba";"2016";"111835";"55119";"56716";"97,18";"96298";"15537";"86,11";3523404
"Itatiba";"2017";"113324";"55828";"57496";"97,1";"97878";"15446";"86,37";3523404
"Itatiba";"2018";"114835";"56547";"58288";"97,01";"99479";"15356";"86,63";3523404
"Itatiba";"2019";"116365";"57275";"59090";"96,93";"101099";"15266";"86,88";3523404
"Itatiba";"2020";"117916";"58013";"59903";"96,84";"102739";"15177";"87,13";3523404
"Itatinga";"2016";"19528";"9946";"9582";"103,8";"18065";"1463";"92,51";3523503
"Itatinga";"2017";"19779";"10068";"9711";"103,68";"18343";"1436";"92,74";3523503
"Itatinga";"2018";"20033";"10192";"9841";"103,57";"18623";"1410";"92,96";3523503
"Itatinga";"2019";"20290";"10317";"9973";"103,45";"18905";"1385";"93,17";3523503
"Itatinga";"2020";"20550";"10443";"10107";"103,32";"19190";"1360";"93,38";3523503
"Itirapina";"2016";"16524";"9647";"6877";"140,28";"15145";"1379";"91,65";3523602
"Itirapina";"2017";"16682";"9725";"6957";"139,79";"15326";"1356";"91,87";3523602
"Itirapina";"2018";"16840";"9803";"7037";"139,31";"15507";"1333";"92,08";3523602
"Itirapina";"2019";"17000";"9882";"7118";"138,83";"15690";"1310";"92,29";3523602
"Itirapina";"2020";"17162";"9962";"7200";"138,36";"15873";"1289";"92,49";3523602
"Itirapuã";"2016";"6131";"3106";"3025";"102,68";"5226";"905";"85,24";3523701
"Itirapuã";"2017";"6167";"3121";"3046";"102,46";"5275";"892";"85,54";3523701
"Itirapuã";"2018";"6204";"3137";"3067";"102,28";"5325";"879";"85,83";3523701
"Itirapuã";"2019";"6242";"3153";"3089";"102,07";"5375";"867";"86,11";3523701
"Itirapuã";"2020";"6279";"3169";"3110";"101,9";"5425";"854";"86,4";3523701
"Itobi";"2016";"7584";"3897";"3687";"105,7";"7035";"549";"92,76";3523800
"Itobi";"2017";"7591";"3896";"3695";"105,44";"7068";"523";"93,11";3523800
"Itobi";"2018";"7596";"3894";"3702";"105,19";"7098";"498";"93,44";3523800
"Itobi";"2019";"7603";"3893";"3710";"104,93";"7129";"474";"93,77";3523800
"Itobi";"2020";"7609";"3891";"3718";"104,65";"7157";"452";"94,06";3523800
"Itu";"2016";"163775";"80807";"82968";"97,4";"154843";"8932";"94,55";3523909
"Itu";"2017";"165253";"81508";"83745";"97,33";"156476";"8777";"94,69";3523909
"Itu";"2018";"166747";"82216";"84531";"97,26";"158121";"8626";"94,83";3523909
"Itu";"2019";"168252";"82929";"85323";"97,19";"159774";"8478";"94,96";3523909
"Itu";"2020";"169772";"83649";"86123";"97,13";"161437";"8335";"95,09";3523909
"Itupeva";"2016";"53551";"27071";"26480";"102,23";"48948";"4603";"91,4";3524006
"Itupeva";"2017";"54901";"27732";"27169";"102,07";"50497";"4404";"91,98";3524006
"Itupeva";"2018";"56285";"28408";"27877";"101,9";"52067";"4218";"92,51";3524006
"Itupeva";"2019";"57704";"29102";"28602";"101,75";"53661";"4043";"92,99";3524006
"Itupeva";"2020";"59159";"29812";"29347";"101,58";"55279";"3880";"93,44";3524006
"Ituverava";"2016";"39688";"19321";"20367";"94,86";"37365";"2323";"94,15";3524105
"Ituverava";"2017";"39827";"19384";"20443";"94,82";"37496";"2331";"94,15";3524105
"Ituverava";"2018";"39966";"19447";"20519";"94,78";"37627";"2339";"94,15";3524105
"Ituverava";"2019";"40106";"19510";"20596";"94,73";"37758";"2348";"94,15";3524105
"Ituverava";"2020";"40246";"19573";"20673";"94,68";"37890";"2356";"94,15";3524105
"Jaborandi";"2016";"6651";"3347";"3304";"101,3";"6284";"367";"94,48";3524204
"Jaborandi";"2017";"6657";"3348";"3309";"101,18";"6298";"359";"94,61";3524204
"Jaborandi";"2018";"6664";"3349";"3315";"101,03";"6313";"351";"94,73";3524204
"Jaborandi";"2019";"6670";"3350";"3320";"100,9";"6326";"344";"94,84";3524204
"Jaborandi";"2020";"6677";"3351";"3326";"100,75";"6340";"337";"94,95";3524204
"Jaboticabal";"2016";"73315";"35583";"37732";"94,3";"71752";"1563";"97,87";3524303
"Jaboticabal";"2017";"73541";"35687";"37854";"94,28";"72057";"1484";"97,98";3524303
"Jaboticabal";"2018";"73766";"35790";"37976";"94,24";"72356";"1410";"98,09";3524303
"Jaboticabal";"2019";"73994";"35895";"38099";"94,22";"72653";"1341";"98,19";3524303
"Jaboticabal";"2020";"74221";"35999";"38222";"94,18";"72946";"1275";"98,28";3524303
"Jacareí";"2016";"221650";"108086";"113564";"95,18";"218589";"3061";"98,62";3524402
"Jacareí";"2017";"223207";"108826";"114381";"95,14";"220124";"3083";"98,62";3524402
"Jacareí";"2018";"224775";"109572";"115203";"95,11";"221671";"3104";"98,62";3524402
"Jacareí";"2019";"226355";"110323";"116032";"95,08";"223229";"3126";"98,62";3524402
"Jacareí";"2020";"227945";"111079";"116866";"95,05";"224797";"3148";"98,62";3524402
"Jaci";"2016";"6464";"3282";"3182";"103,14";"5814";"650";"89,94";3524501
"Jaci";"2017";"6587";"3341";"3246";"102,93";"5953";"634";"90,37";3524501
"Jaci";"2018";"6712";"3401";"3311";"102,72";"6092";"620";"90,76";3524501
"Jaci";"2019";"6839";"3462";"3377";"102,52";"6231";"608";"91,11";3524501
"Jaci";"2020";"6969";"3524";"3445";"102,29";"6371";"598";"91,42";3524501
"Jacupiranga";"2016";"17169";"8717";"8452";"103,14";"9348";"7821";"54,45";3524600
"Jacupiranga";"2017";"17182";"8717";"8465";"102,98";"9355";"7827";"54,45";3524600
"Jacupiranga";"2018";"17195";"8718";"8477";"102,84";"9362";"7833";"54,45";3524600
"Jacupiranga";"2019";"17208";"8718";"8490";"102,69";"9369";"7839";"54,45";3524600
"Jacupiranga";"2020";"17222";"8719";"8503";"102,54";"9377";"7845";"54,45";3524600
"Jaguariúna";"2016";"51248";"25338";"25910";"97,79";"50221";"1027";"98";3524709
"Jaguariúna";"2017";"52125";"25757";"26368";"97,68";"51111";"1014";"98,05";3524709
"Jaguariúna";"2018";"53018";"26184";"26834";"97,58";"52012";"1006";"98,1";3524709
"Jaguariúna";"2019";"53925";"26617";"27308";"97,47";"52922";"1003";"98,14";3524709
"Jaguariúna";"2020";"54848";"27057";"27791";"97,36";"53844";"1004";"98,17";3524709
"Jales";"2016";"47187";"22971";"24216";"94,86";"44404";"2783";"94,1";3524808
"Jales";"2017";"47204";"22967";"24237";"94,76";"44420";"2784";"94,1";3524808
"Jales";"2018";"47220";"22962";"24258";"94,66";"44435";"2785";"94,1";3524808
"Jales";"2019";"47237";"22958";"24279";"94,56";"44451";"2786";"94,1";3524808
"Jales";"2020";"47254";"22954";"24300";"94,46";"44467";"2787";"94,1";3524808
"Jambeiro";"2016";"5916";"3033";"2883";"105,2";"2832";"3084";"47,87";3524907
"Jambeiro";"2017";"5989";"3066";"2923";"104,89";"2867";"3122";"47,87";3524907
"Jambeiro";"2018";"6064";"3100";"2964";"104,59";"2903";"3161";"47,87";3524907
"Jambeiro";"2019";"6138";"3134";"3004";"104,33";"2939";"3199";"47,88";3524907
"Jambeiro";"2020";"6214";"3168";"3046";"104,01";"2975";"3239";"47,88";3524907
"Jandira";"2016";"117518";"57515";"60003";"95,85";"117518";"-";"100";3525003
"Jandira";"2017";"119011";"58238";"60773";"95,83";"119011";"-";"100";3525003
"Jandira";"2018";"120523";"58971";"61552";"95,81";"120523";"-";"100";3525003
"Jandira";"2019";"122053";"59712";"62341";"95,78";"122053";"-";"100";3525003
"Jandira";"2020";"123603";"60463";"63140";"95,76";"123603";"-";"100";3525003
"Jardinópolis";"2016";"40962";"20529";"20433";"100,47";"39910";"1052";"97,43";3525102
"Jardinópolis";"2017";"41436";"20755";"20681";"100,36";"40448";"988";"97,62";3525102
"Jardinópolis";"2018";"41916";"20984";"20932";"100,25";"40987";"929";"97,78";3525102
"Jardinópolis";"2019";"42402";"21216";"21186";"100,14";"41528";"874";"97,94";3525102
"Jardinópolis";"2020";"42893";"21450";"21443";"100,03";"42070";"823";"98,08";3525102
"Jarinu";"2016";"27510";"13755";"13755";"100";"22853";"4657";"83,07";3525201
"Jarinu";"2017";"28070";"14020";"14050";"99,79";"23550";"4520";"83,9";3525201
"Jarinu";"2018";"28642";"14291";"14351";"99,58";"24256";"4386";"84,69";3525201
"Jarinu";"2019";"29225";"14567";"14658";"99,38";"24970";"4255";"85,44";3525201
"Jarinu";"2020";"29820";"14848";"14972";"99,17";"25692";"4128";"86,16";3525201
"Jaú";"2016";"141344";"69060";"72284";"95,54";"137568";"3776";"97,33";3525300
"Jaú";"2017";"142860";"69774";"73086";"95,47";"139130";"3730";"97,39";3525300
"Jaú";"2018";"144392";"70495";"73897";"95,4";"140705";"3687";"97,45";3525300
"Jaú";"2019";"145940";"71224";"74716";"95,33";"142291";"3649";"97,5";3525300
"Jaú";"2020";"147505";"71960";"75545";"95,25";"143891";"3614";"97,55";3525300
"Jeriquara";"2016";"3146";"1610";"1536";"104,82";"2685";"461";"85,35";3525409
"Jeriquara";"2017";"3145";"1608";"1537";"104,62";"2698";"447";"85,79";3525409
"Jeriquara";"2018";"3144";"1607";"1537";"104,55";"2711";"433";"86,23";3525409
"Jeriquara";"2019";"3143";"1605";"1538";"104,36";"2723";"420";"86,64";3525409
"Jeriquara";"2020";"3141";"1603";"1538";"104,23";"2733";"408";"87,01";3525409
"Joanópolis";"2016";"12336";"6188";"6148";"100,65";"12336";"-";"100";3525508
"Joanópolis";"2017";"12418";"6225";"6193";"100,52";"12418";"-";"100";3525508
"Joanópolis";"2018";"12500";"6262";"6238";"100,38";"12500";"-";"100";3525508
"Joanópolis";"2019";"12583";"6299";"6284";"100,24";"12583";"-";"100";3525508
"Joanópolis";"2020";"12666";"6336";"6330";"100,09";"12666";"-";"100";3525508
"João Ramalho";"2016";"4290";"2174";"2116";"102,74";"3764";"526";"87,74";3525607
"João Ramalho";"2017";"4313";"2186";"2127";"102,77";"3799";"514";"88,08";3525607
"João Ramalho";"2018";"4336";"2198";"2138";"102,81";"3833";"503";"88,4";3525607
"João Ramalho";"2019";"4361";"2211";"2150";"102,84";"3869";"492";"88,72";3525607
"João Ramalho";"2020";"4384";"2223";"2161";"102,87";"3903";"481";"89,03";3525607
"José Bonifácio";"2016";"34726";"17278";"17448";"99,03";"31873";"2853";"91,78";3525706
"José Bonifácio";"2017";"35036";"17425";"17611";"98,94";"32211";"2825";"91,94";3525706
"José Bonifácio";"2018";"35348";"17573";"17775";"98,86";"32548";"2800";"92,08";3525706
"José Bonifácio";"2019";"35663";"17722";"17941";"98,78";"32885";"2778";"92,21";3525706
"José Bonifácio";"2020";"35981";"17873";"18108";"98,7";"33223";"2758";"92,33";3525706
"Júlio Mesquita";"2016";"4547";"2219";"2328";"95,32";"4338";"209";"95,4";3525805
"Júlio Mesquita";"2017";"4570";"2228";"2342";"95,13";"4361";"209";"95,43";3525805
"Júlio Mesquita";"2018";"4593";"2237";"2356";"94,95";"4384";"209";"95,45";3525805
"Júlio Mesquita";"2019";"4617";"2246";"2371";"94,73";"4407";"210";"95,45";3525805
"Júlio Mesquita";"2020";"4640";"2255";"2385";"94,55";"4430";"210";"95,47";3525805
"Jumirim";"2016";"3120";"1605";"1515";"105,94";"1958";"1162";"62,76";3525854
"Jumirim";"2017";"3166";"1627";"1539";"105,72";"2011";"1155";"63,52";3525854
"Jumirim";"2018";"3211";"1649";"1562";"105,57";"2064";"1147";"64,28";3525854
"Jumirim";"2019";"3258";"1672";"1586";"105,42";"2119";"1139";"65,04";3525854
"Jumirim";"2020";"3306";"1695";"1611";"105,21";"2175";"1131";"65,79";3525854
"Jundiaí";"2016";"394185";"192467";"201718";"95,41";"380960";"13225";"96,64";3525904
"Jundiaí";"2017";"397353";"194003";"203350";"95,4";"384500";"12853";"96,77";3525904
"Jundiaí";"2018";"400549";"195553";"204996";"95,39";"388041";"12508";"96,88";3525904
"Jundiaí";"2019";"403769";"197114";"206655";"95,38";"391578";"12191";"96,98";3525904
"Jundiaí";"2020";"407016";"198688";"208328";"95,37";"395118";"11898";"97,08";3525904
"Junqueirópolis";"2016";"19534";"10272";"9262";"110,9";"16406";"3128";"83,99";3526001
"Junqueirópolis";"2017";"19666";"10332";"9334";"110,69";"16571";"3095";"84,26";3526001
"Junqueirópolis";"2018";"19798";"10391";"9407";"110,46";"16736";"3062";"84,53";3526001
"Junqueirópolis";"2019";"19932";"10452";"9480";"110,25";"16903";"3029";"84,8";3526001
"Junqueirópolis";"2020";"20065";"10511";"9554";"110,02";"17068";"2997";"85,06";3526001
"Juquiá";"2016";"18896";"9486";"9410";"100,81";"12183";"6713";"64,47";3526100
"Juquiá";"2017";"18878";"9466";"9412";"100,57";"12214";"6664";"64,7";3526100
"Juquiá";"2018";"18862";"9447";"9415";"100,34";"12247";"6615";"64,93";3526100
"Juquiá";"2019";"18844";"9427";"9417";"100,11";"12278";"6566";"65,16";3526100
"Juquiá";"2020";"18828";"9408";"9420";"99,87";"12310";"6518";"65,38";3526100
"Juquitiba";"2016";"29684";"14943";"14741";"101,37";"24588";"5096";"82,83";3526209
"Juquitiba";"2017";"29862";"15020";"14842";"101,2";"24972";"4890";"83,62";3526209
"Juquitiba";"2018";"30040";"15098";"14942";"101,04";"25349";"4691";"84,38";3526209
"Juquitiba";"2019";"30220";"15176";"15044";"100,88";"25721";"4499";"85,11";3526209
"Juquitiba";"2020";"30401";"15255";"15146";"100,72";"26087";"4314";"85,81";3526209
"Lagoinha";"2016";"4818";"2440";"2378";"102,61";"3305";"1513";"68,6";3526308
"Lagoinha";"2017";"4819";"2437";"2382";"102,31";"3335";"1484";"69,21";3526308
"Lagoinha";"2018";"4818";"2433";"2385";"102,01";"3364";"1454";"69,82";3526308
"Lagoinha";"2019";"4819";"2430";"2389";"101,72";"3393";"1426";"70,41";3526308
"Lagoinha";"2020";"4819";"2426";"2393";"101,38";"3421";"1398";"70,99";3526308
"Laranjal Paulista";"2016";"26830";"13212";"13618";"97,02";"24193";"2637";"90,17";3526407
"Laranjal Paulista";"2017";"27077";"13329";"13748";"96,95";"24442";"2635";"90,27";3526407
"Laranjal Paulista";"2018";"27327";"13447";"13880";"96,88";"24695";"2632";"90,37";3526407
"Laranjal Paulista";"2019";"27580";"13567";"14013";"96,82";"24951";"2629";"90,47";3526407
"Laranjal Paulista";"2020";"27834";"13687";"14147";"96,75";"25207";"2627";"90,56";3526407
"Lavínia";"2016";"8594";"6052";"2542";"238,08";"4195";"4399";"48,81";3526506
"Lavínia";"2017";"8570";"6038";"2532";"238,47";"4183";"4387";"48,81";3526506
"Lavínia";"2018";"8547";"6025";"2522";"238,9";"4172";"4375";"48,81";3526506
"Lavínia";"2019";"8524";"6011";"2513";"239,2";"4161";"4363";"48,82";3526506
"Lavínia";"2020";"8500";"5997";"2503";"239,59";"4148";"4352";"48,8";3526506
"Lavrinhas";"2016";"6938";"3477";"3461";"100,46";"6471";"467";"93,27";3526605
"Lavrinhas";"2017";"6995";"3504";"3491";"100,37";"6539";"456";"93,48";3526605
"Lavrinhas";"2018";"7051";"3530";"3521";"100,26";"6606";"445";"93,69";3526605
"Lavrinhas";"2019";"7109";"3557";"3552";"100,14";"6674";"435";"93,88";3526605
"Lavrinhas";"2020";"7167";"3584";"3583";"100,03";"6741";"426";"94,06";3526605
"Leme";"2016";"97403";"48692";"48711";"99,96";"95606";"1797";"98,16";3526704
"Leme";"2017";"98284";"49106";"49178";"99,85";"96490";"1794";"98,17";3526704
"Leme";"2018";"99172";"49523";"49649";"99,75";"97378";"1794";"98,19";3526704
"Leme";"2019";"100069";"49944";"50125";"99,64";"98272";"1797";"98,2";3526704
"Leme";"2020";"100975";"50369";"50606";"99,53";"99174";"1801";"98,22";3526704
"Lençóis Paulista";"2016";"64470";"31922";"32548";"98,08";"63264";"1206";"98,13";3526803
"Lençóis Paulista";"2017";"64933";"32136";"32797";"97,98";"63739";"1194";"98,16";3526803
"Lençóis Paulista";"2018";"65399";"32351";"33048";"97,89";"64214";"1185";"98,19";3526803
"Lençóis Paulista";"2019";"65870";"32569";"33301";"97,8";"64691";"1179";"98,21";3526803
"Lençóis Paulista";"2020";"66343";"32787";"33556";"97,71";"65168";"1175";"98,23";3526803
"Limeira";"2016";"288741";"141675";"147066";"96,33";"281402";"7339";"97,46";3526902
"Limeira";"2017";"290613";"142556";"148057";"96,28";"283392";"7221";"97,52";3526902
"Limeira";"2018";"292497";"143442";"149055";"96,23";"285384";"7113";"97,57";3526902
"Limeira";"2019";"294392";"144333";"150059";"96,18";"287379";"7013";"97,62";3526902
"Limeira";"2020";"296300";"145230";"151070";"96,13";"289378";"6922";"97,66";3526902
"Lindóia";"2016";"7370";"3638";"3732";"97,48";"7370";"-";"100";3527009
"Lindóia";"2017";"7456";"3678";"3778";"97,35";"7456";"-";"100";3527009
"Lindóia";"2018";"7544";"3719";"3825";"97,23";"7544";"-";"100";3527009
"Lindóia";"2019";"7632";"3760";"3872";"97,11";"7632";"-";"100";3527009
"Lindóia";"2020";"7722";"3802";"3920";"96,99";"7722";"-";"100";3527009
"Lins";"2016";"73801";"35804";"37997";"94,23";"72938";"863";"98,83";3527108
"Lins";"2017";"74120";"35958";"38162";"94,22";"73254";"866";"98,83";3527108
"Lins";"2018";"74441";"36113";"38328";"94,22";"73571";"870";"98,83";3527108
"Lins";"2019";"74763";"36268";"38495";"94,21";"73889";"874";"98,83";3527108
"Lins";"2020";"75087";"36425";"38662";"94,21";"74209";"878";"98,83";3527108
"Lorena";"2016";"85046";"41071";"43975";"93,4";"82854";"2192";"97,42";3527207
"Lorena";"2017";"85442";"41262";"44180";"93,4";"83271";"2171";"97,46";3527207
"Lorena";"2018";"85839";"41454";"44385";"93,4";"83688";"2151";"97,49";3527207
"Lorena";"2019";"86238";"41647";"44591";"93,4";"84105";"2133";"97,53";3527207
"Lorena";"2020";"86639";"41841";"44798";"93,4";"84522";"2117";"97,56";3527207
"Lourdes";"2016";"2166";"1126";"1040";"108,27";"1826";"340";"84,3";3527256
"Lourdes";"2017";"2171";"1128";"1043";"108,15";"1838";"333";"84,66";3527256
"Lourdes";"2018";"2174";"1129";"1045";"108,04";"1848";"326";"85";3527256
"Lourdes";"2019";"2179";"1131";"1048";"107,92";"1860";"319";"85,36";3527256
"Lourdes";"2020";"2182";"1132";"1050";"107,81";"1870";"312";"85,7";3527256
"Louveira";"2016";"44269";"22357";"21912";"102,03";"43042";"1227";"97,23";3527306
"Louveira";"2017";"45236";"22834";"22402";"101,93";"44035";"1201";"97,35";3527306
"Louveira";"2018";"46225";"23322";"22903";"101,83";"45046";"1179";"97,45";3527306
"Louveira";"2019";"47236";"23820";"23416";"101,73";"46075";"1161";"97,54";3527306
"Louveira";"2020";"48268";"24328";"23940";"101,62";"47122";"1146";"97,63";3527306
"Lucélia";"2016";"20596";"10852";"9744";"111,37";"17943";"2653";"87,12";3527405
"Lucélia";"2017";"20701";"10896";"9805";"111,13";"18051";"2650";"87,2";3527405
"Lucélia";"2018";"20806";"10940";"9866";"110,89";"18160";"2646";"87,28";3527405
"Lucélia";"2019";"20912";"10984";"9928";"110,64";"18270";"2642";"87,37";3527405
"Lucélia";"2020";"21019";"11029";"9990";"110,4";"18381";"2638";"87,45";3527405
"Lucianópolis";"2016";"2251";"1113";"1138";"97,8";"1814";"437";"80,59";3527504
"Lucianópolis";"2017";"2254";"1114";"1140";"97,72";"1822";"432";"80,83";3527504
"Lucianópolis";"2018";"2256";"1114";"1142";"97,55";"1828";"428";"81,03";3527504
"Lucianópolis";"2019";"2259";"1115";"1144";"97,47";"1836";"423";"81,27";3527504
"Lucianópolis";"2020";"2261";"1115";"1146";"97,29";"1843";"418";"81,51";3527504
"Luís Antônio";"2016";"13161";"6782";"6379";"106,32";"12896";"265";"97,99";3527603
"Luís Antônio";"2017";"13406";"6905";"6501";"106,21";"13158";"248";"98,15";3527603
"Luís Antônio";"2018";"13654";"7030";"6624";"106,13";"13421";"233";"98,29";3527603
"Luís Antônio";"2019";"13907";"7157";"6750";"106,03";"13689";"218";"98,43";3527603
"Luís Antônio";"2020";"14166";"7287";"6879";"105,93";"13961";"205";"98,55";3527603
"Luiziânia";"2016";"5465";"2828";"2637";"107,24";"5115";"350";"93,6";3527702
"Luiziânia";"2017";"5536";"2863";"2673";"107,11";"5196";"340";"93,86";3527702
"Luiziânia";"2018";"5607";"2898";"2709";"106,98";"5277";"330";"94,11";3527702
"Luiziânia";"2019";"5680";"2934";"2746";"106,85";"5359";"321";"94,35";3527702
"Luiziânia";"2020";"5754";"2970";"2784";"106,68";"5441";"313";"94,56";3527702
"Lupércio";"2016";"4393";"2131";"2262";"94,21";"4126";"267";"93,92";3527801
"Lupércio";"2017";"4400";"2133";"2267";"94,09";"4148";"252";"94,27";3527801
"Lupércio";"2018";"4407";"2136";"2271";"94,06";"4166";"241";"94,53";3527801
"Lupércio";"2019";"4414";"2138";"2276";"93,94";"4182";"232";"94,74";3527801
"Lupércio";"2020";"4421";"2140";"2281";"93,82";"4196";"225";"94,91";3527801
"Lutécia";"2016";"2652";"1317";"1335";"98,65";"2181";"471";"82,24";3527900
"Lutécia";"2017";"2644";"1312";"1332";"98,5";"2185";"459";"82,64";3527900
"Lutécia";"2018";"2637";"1307";"1330";"98,27";"2190";"447";"83,05";3527900
"Lutécia";"2019";"2629";"1302";"1327";"98,12";"2194";"435";"83,45";3527900
"Lutécia";"2020";"2621";"1297";"1324";"97,96";"2197";"424";"83,82";3527900
"Macatuba";"2016";"16672";"8346";"8326";"100,24";"16267";"405";"97,57";3528007
"Macatuba";"2017";"16736";"8375";"8361";"100,17";"16340";"396";"97,63";3528007
"Macatuba";"2018";"16801";"8405";"8396";"100,11";"16413";"388";"97,69";3528007
"Macatuba";"2019";"16867";"8435";"8432";"100,04";"16487";"380";"97,75";3528007
"Macatuba";"2020";"16932";"8465";"8467";"99,98";"16559";"373";"97,8";3528007
"Macaubal";"2016";"7736";"3890";"3846";"101,14";"6955";"781";"89,9";3528106
"Macaubal";"2017";"7740";"3888";"3852";"100,93";"6975";"765";"90,12";3528106
"Macaubal";"2018";"7742";"3885";"3857";"100,73";"6993";"749";"90,33";3528106
"Macaubal";"2019";"7746";"3883";"3863";"100,52";"7011";"735";"90,51";3528106
"Macaubal";"2020";"7749";"3881";"3868";"100,34";"7028";"721";"90,7";3528106
"Macedônia";"2016";"3609";"1796";"1813";"99,06";"2820";"789";"78,14";3528205
"Macedônia";"2017";"3600";"1790";"1810";"98,9";"2826";"774";"78,5";3528205
"Macedônia";"2018";"3591";"1783";"1808";"98,62";"2832";"759";"78,86";3528205
"Macedônia";"2019";"3582";"1777";"1805";"98,45";"2838";"744";"79,23";3528205
"Macedônia";"2020";"3574";"1771";"1803";"98,23";"2844";"730";"79,57";3528205
"Magda";"2016";"3133";"1599";"1534";"104,24";"2650";"483";"84,58";3528304
"Magda";"2017";"3122";"1591";"1531";"103,92";"2648";"474";"84,82";3528304
"Magda";"2018";"3110";"1583";"1527";"103,67";"2646";"464";"85,08";3528304
"Magda";"2019";"3099";"1575";"1524";"103,35";"2644";"455";"85,32";3528304
"Magda";"2020";"3088";"1567";"1521";"103,02";"2641";"447";"85,52";3528304
"Mairinque";"2016";"45149";"22416";"22733";"98,61";"36236";"8913";"80,26";3528403
"Mairinque";"2017";"45439";"22547";"22892";"98,49";"36469";"8970";"80,26";3528403
"Mairinque";"2018";"45732";"22679";"23053";"98,38";"36704";"9028";"80,26";3528403
"Mairinque";"2019";"46027";"22812";"23215";"98,26";"36940";"9087";"80,26";3528403
"Mairinque";"2020";"46323";"22945";"23378";"98,15";"37178";"9145";"80,26";3528403
"Mairiporã";"2016";"91745";"46175";"45570";"101,33";"83059";"8686";"90,53";3528502
"Mairiporã";"2017";"93418";"46980";"46438";"101,17";"84987";"8431";"90,97";3528502
"Mairiporã";"2018";"95122";"47800";"47322";"101,01";"86939";"8183";"91,4";3528502
"Mairiporã";"2019";"96856";"48633";"48223";"100,85";"88912";"7944";"91,8";3528502
"Mairiporã";"2020";"98622";"49481";"49141";"100,69";"90911";"7711";"92,18";3528502
"Manduri";"2016";"9328";"4647";"4681";"99,27";"8425";"903";"90,32";3528601
"Manduri";"2017";"9378";"4666";"4712";"99,02";"8519";"859";"90,84";3528601
"Manduri";"2018";"9426";"4684";"4742";"98,78";"8609";"817";"91,33";3528601
"Manduri";"2019";"9475";"4702";"4773";"98,51";"8698";"777";"91,8";3528601
"Manduri";"2020";"9525";"4721";"4804";"98,27";"8786";"739";"92,24";3528601
"Marabá Paulista";"2016";"4880";"3064";"1816";"168,72";"2172";"2708";"44,51";3528700
"Marabá Paulista";"2017";"4893";"3069";"1824";"168,26";"2178";"2715";"44,51";3528700
"Marabá Paulista";"2018";"4905";"3074";"1831";"167,89";"2183";"2722";"44,51";3528700
"Marabá Paulista";"2019";"4918";"3079";"1839";"167,43";"2189";"2729";"44,51";3528700
"Marabá Paulista";"2020";"4931";"3084";"1847";"166,97";"2195";"2736";"44,51";3528700
"Maracaí";"2016";"13457";"6692";"6765";"98,92";"12359";"1098";"91,84";3528809
"Maracaí";"2017";"13473";"6695";"6778";"98,78";"12396";"1077";"92,01";3528809
"Maracaí";"2018";"13489";"6699";"6790";"98,66";"12433";"1056";"92,17";3528809
"Maracaí";"2019";"13505";"6702";"6803";"98,52";"12468";"1037";"92,32";3528809
"Maracaí";"2020";"13521";"6705";"6816";"98,37";"12503";"1018";"92,47";3528809
"Marapoama";"2016";"2805";"1430";"1375";"104";"2472";"333";"88,13";3528858
"Marapoama";"2017";"2830";"1442";"1388";"103,89";"2510";"320";"88,69";3528858
"Marapoama";"2018";"2856";"1454";"1402";"103,71";"2547";"309";"89,18";3528858
"Marapoama";"2019";"2880";"1465";"1415";"103,53";"2582";"298";"89,65";3528858
"Marapoama";"2020";"2906";"1477";"1429";"103,36";"2617";"289";"90,06";3528858
"Mariápolis";"2016";"3954";"2024";"1930";"104,87";"3308";"646";"83,66";3528908
"Mariápolis";"2017";"3959";"2025";"1934";"104,71";"3333";"626";"84,19";3528908
"Mariápolis";"2018";"3964";"2025";"1939";"104,44";"3358";"606";"84,71";3528908
"Mariápolis";"2019";"3969";"2026";"1943";"104,27";"3382";"587";"85,21";3528908
"Mariápolis";"2020";"3975";"2027";"1948";"104,06";"3406";"569";"85,69";3528908
"Marília";"2016";"226005";"109053";"116952";"93,25";"215866";"10139";"95,51";3529005
"Marília";"2017";"227380";"109702";"117678";"93,22";"217179";"10201";"95,51";3529005
"Marília";"2018";"228763";"110355";"118408";"93,2";"218500";"10263";"95,51";3529005
"Marília";"2019";"230154";"111011";"119143";"93,17";"219828";"10326";"95,51";3529005
"Marília";"2020";"231554";"111671";"119883";"93,15";"221166";"10388";"95,51";3529005
"Marinópolis";"2016";"2100";"1059";"1041";"101,73";"1704";"396";"81,14";3529104
"Marinópolis";"2017";"2100";"1059";"1041";"101,73";"1711";"389";"81,48";3529104
"Marinópolis";"2018";"2098";"1058";"1040";"101,73";"1716";"382";"81,79";3529104
"Marinópolis";"2019";"2098";"1058";"1040";"101,73";"1722";"376";"82,08";3529104
"Marinópolis";"2020";"2097";"1058";"1039";"101,83";"1728";"369";"82,4";3529104
"Martinópolis";"2016";"25102";"12990";"12112";"107,25";"21541";"3561";"85,81";3529203
"Martinópolis";"2017";"25242";"13053";"12189";"107,09";"21733";"3509";"86,1";3529203
"Martinópolis";"2018";"25384";"13118";"12266";"106,95";"21926";"3458";"86,38";3529203
"Martinópolis";"2019";"25526";"13182";"12344";"106,79";"22118";"3408";"86,65";3529203
"Martinópolis";"2020";"25668";"13246";"12422";"106,63";"22310";"3358";"86,92";3529203
"Matão";"2016";"78890";"38957";"39933";"97,56";"77442";"1448";"98,16";3529302
"Matão";"2017";"79171";"39075";"40096";"97,45";"77718";"1453";"98,16";3529302
"Matão";"2018";"79453";"39193";"40260";"97,35";"77995";"1458";"98,16";3529302
"Matão";"2019";"79736";"39311";"40425";"97,24";"78273";"1463";"98,17";3529302
"Matão";"2020";"80020";"39430";"40590";"97,14";"78552";"1468";"98,17";3529302
"Mauá";"2016";"443910";"216959";"226951";"95,6";"443910";"-";"100";3529401
"Mauá";"2017";"447911";"218882";"229029";"95,57";"447911";"-";"100";3529401
"Mauá";"2018";"451947";"220821";"231126";"95,54";"451947";"-";"100";3529401
"Mauá";"2019";"456020";"222777";"233243";"95,51";"456020";"-";"100";3529401
"Mauá";"2020";"460132";"224753";"235379";"95,49";"460132";"-";"100";3529401
"Mendonça";"2016";"4899";"2472";"2427";"101,85";"4173";"726";"85,18";3529500
"Mendonça";"2017";"4934";"2488";"2446";"101,72";"4227";"707";"85,67";3529500
"Mendonça";"2018";"4971";"2505";"2466";"101,58";"4281";"690";"86,12";3529500
"Mendonça";"2019";"5006";"2521";"2485";"101,45";"4333";"673";"86,56";3529500
"Mendonça";"2020";"5043";"2538";"2505";"101,32";"4386";"657";"86,97";3529500
"Meridiano";"2016";"3786";"1839";"1947";"94,45";"2697";"1089";"71,24";3529609
"Meridiano";"2017";"3775";"1831";"1944";"94,19";"2701";"1074";"71,55";3529609
"Meridiano";"2018";"3762";"1822";"1940";"93,92";"2703";"1059";"71,85";3529609
"Meridiano";"2019";"3751";"1814";"1937";"93,65";"2706";"1045";"72,14";3529609
"Meridiano";"2020";"3739";"1805";"1934";"93,33";"2709";"1030";"72,45";3529609
"Mesópolis";"2016";"1888";"947";"941";"100,64";"1579";"309";"83,63";3529658
"Mesópolis";"2017";"1890";"946";"944";"100,21";"1595";"295";"84,39";3529658
"Mesópolis";"2018";"1890";"944";"946";"99,79";"1608";"282";"85,08";3529658
"Mesópolis";"2019";"1892";"943";"949";"99,37";"1623";"269";"85,78";3529658
"Mesópolis";"2020";"1893";"942";"951";"99,05";"1635";"258";"86,37";3529658
"Miguelópolis";"2016";"21061";"10473";"10588";"98,91";"20015";"1046";"95,03";3529708
"Miguelópolis";"2017";"21151";"10513";"10638";"98,82";"20127";"1024";"95,16";3529708
"Miguelópolis";"2018";"21242";"10553";"10689";"98,73";"20238";"1004";"95,27";3529708
"Miguelópolis";"2019";"21333";"10593";"10740";"98,63";"20349";"984";"95,39";3529708
"Miguelópolis";"2020";"21424";"10633";"10791";"98,54";"20459";"965";"95,5";3529708
"Mineiros do Tietê";"2016";"12377";"6145";"6232";"98,6";"11824";"553";"95,53";3529807
"Mineiros do Tietê";"2017";"12432";"6170";"6262";"98,53";"11876";"556";"95,53";3529807
"Mineiros do Tietê";"2018";"12487";"6195";"6292";"98,46";"11929";"558";"95,53";3529807
"Mineiros do Tietê";"2019";"12542";"6220";"6322";"98,39";"11981";"561";"95,53";3529807
"Mineiros do Tietê";"2020";"12597";"6245";"6352";"98,32";"12034";"563";"95,53";3529807
"Mira Estrela";"2016";"2893";"1430";"1463";"97,74";"1930";"963";"66,71";3530003
"Mira Estrela";"2017";"2905";"1434";"1471";"97,48";"1938";"967";"66,71";3530003
"Mira Estrela";"2018";"2916";"1438";"1478";"97,29";"1945";"971";"66,7";3530003
"Mira Estrela";"2019";"2928";"1442";"1486";"97,04";"1953";"975";"66,7";3530003
"Mira Estrela";"2020";"2939";"1446";"1493";"96,85";"1960";"979";"66,69";3530003
"Miracatu";"2016";"20008";"10002";"10006";"99,96";"10600";"9408";"52,98";3529906
"Miracatu";"2017";"19990";"9977";"10013";"99,64";"10643";"9347";"53,24";3529906
"Miracatu";"2018";"19971";"9952";"10019";"99,33";"10684";"9287";"53,5";3529906
"Miracatu";"2019";"19952";"9926";"10026";"99";"10726";"9226";"53,76";3529906
"Miracatu";"2020";"19934";"9901";"10033";"98,68";"10767";"9167";"54,01";3529906
"Mirandópolis";"2016";"28232";"15358";"12874";"119,29";"25540";"2692";"90,46";3530102
"Mirandópolis";"2017";"28335";"15402";"12933";"119,09";"25697";"2638";"90,69";3530102
"Mirandópolis";"2018";"28438";"15446";"12992";"118,89";"25852";"2586";"90,91";3530102
"Mirandópolis";"2019";"28543";"15491";"13052";"118,69";"26008";"2535";"91,12";3530102
"Mirandópolis";"2020";"28646";"15534";"13112";"118,47";"26161";"2485";"91,33";3530102
"Mirante do Paranapanema";"2016";"17498";"8812";"8686";"101,45";"10304";"7194";"58,89";3530201
"Mirante do Paranapanema";"2017";"17566";"8836";"8730";"101,21";"10344";"7222";"58,89";3530201
"Mirante do Paranapanema";"2018";"17634";"8860";"8774";"100,98";"10384";"7250";"58,89";3530201
"Mirante do Paranapanema";"2019";"17701";"8883";"8818";"100,74";"10423";"7278";"58,88";3530201
"Mirante do Paranapanema";"2020";"17769";"8907";"8862";"100,51";"10463";"7306";"58,88";3530201
"Mirassol";"2016";"56311";"27624";"28687";"96,29";"54888";"1423";"97,47";3530300
"Mirassol";"2017";"56685";"27805";"28880";"96,28";"55253";"1432";"97,47";3530300
"Mirassol";"2018";"57062";"27988";"29074";"96,26";"55620";"1442";"97,47";3530300
"Mirassol";"2019";"57442";"28173";"29269";"96,26";"55991";"1451";"97,47";3530300
"Mirassol";"2020";"57824";"28358";"29466";"96,24";"56363";"1461";"97,47";3530300
"Mirassolândia";"2016";"4540";"2307";"2233";"103,31";"3691";"849";"81,3";3530409
"Mirassolândia";"2017";"4580";"2326";"2254";"103,19";"3724";"856";"81,31";3530409
"Mirassolândia";"2018";"4621";"2345";"2276";"103,03";"3757";"864";"81,3";3530409
"Mirassolândia";"2019";"4661";"2364";"2297";"102,92";"3790";"871";"81,31";3530409
"Mirassolândia";"2020";"4702";"2383";"2319";"102,76";"3823";"879";"81,31";3530409
"Mococa";"2016";"66557";"33067";"33490";"98,74";"62634";"3923";"94,11";3530508
"Mococa";"2017";"66606";"33071";"33535";"98,62";"62847";"3759";"94,36";3530508
"Mococa";"2018";"66655";"33076";"33579";"98,5";"63051";"3604";"94,59";3530508
"Mococa";"2019";"66703";"33080";"33623";"98,39";"63245";"3458";"94,82";3530508
"Mococa";"2020";"66753";"33085";"33668";"98,27";"63433";"3320";"95,03";3530508
"Mogi das Cruzes";"2016";"415107";"202055";"213052";"94,84";"384031";"31076";"92,51";3530607
"Mogi das Cruzes";"2017";"419486";"204174";"215312";"94,83";"388333";"31153";"92,57";3530607
"Mogi das Cruzes";"2018";"423912";"206316";"217596";"94,82";"392682";"31230";"92,63";3530607
"Mogi das Cruzes";"2019";"428384";"208480";"219904";"94,81";"397077";"31307";"92,69";3530607
"Mogi das Cruzes";"2020";"432905";"210668";"222237";"94,79";"401520";"31385";"92,75";3530607
"Mogi Guaçu";"2016";"144106";"71271";"72835";"97,85";"137735";"6371";"95,58";3530706
"Mogi Guaçu";"2017";"145149";"71750";"73399";"97,75";"138869";"6280";"95,67";3530706
"Mogi Guaçu";"2018";"146200";"72232";"73968";"97,65";"140009";"6191";"95,77";3530706
"Mogi Guaçu";"2019";"147259";"72718";"74541";"97,55";"141153";"6106";"95,85";3530706
"Mogi Guaçu";"2020";"148325";"73207";"75118";"97,46";"142302";"6023";"95,94";3530706
"Mogi Mirim";"2016";"89042";"43722";"45320";"96,47";"84609";"4433";"95,02";3530805
"Mogi Mirim";"2017";"89390";"43870";"45520";"96,38";"85115";"4275";"95,22";3530805
"Mogi Mirim";"2018";"89738";"44018";"45720";"96,28";"85611";"4127";"95,4";3530805
"Mogi Mirim";"2019";"90089";"44167";"45922";"96,18";"86102";"3987";"95,57";3530805
"Mogi Mirim";"2020";"90439";"44315";"46124";"96,08";"86584";"3855";"95,74";3530805
"Mombuca";"2016";"3307";"1675";"1632";"102,63";"2853";"454";"86,27";3530904
"Mombuca";"2017";"3313";"1677";"1636";"102,51";"2878";"435";"86,87";3530904
"Mombuca";"2018";"3320";"1679";"1641";"102,32";"2902";"418";"87,41";3530904
"Mombuca";"2019";"3326";"1681";"1645";"102,19";"2926";"400";"87,97";3530904
"Mombuca";"2020";"3332";"1683";"1649";"102,06";"2948";"384";"88,48";3530904
"Mongaguá";"2016";"51380";"25467";"25913";"98,28";"51156";"224";"99,56";3531100
"Mongaguá";"2017";"52169";"25841";"26328";"98,15";"51941";"228";"99,56";3531100
"Mongaguá";"2018";"52970";"26220";"26750";"98,02";"52739";"231";"99,56";3531100
"Mongaguá";"2019";"53784";"26605";"27179";"97,89";"53549";"235";"99,56";3531100
"Mongaguá";"2020";"54610";"26995";"27615";"97,75";"54372";"238";"99,56";3531100
"Monte Alegre do Sul";"2016";"7536";"3761";"3775";"99,63";"4543";"2993";"60,28";3531209
"Monte Alegre do Sul";"2017";"7589";"3786";"3803";"99,55";"4614";"2975";"60,8";3531209
"Monte Alegre do Sul";"2018";"7642";"3812";"3830";"99,53";"4684";"2958";"61,29";3531209
"Monte Alegre do Sul";"2019";"7695";"3837";"3858";"99,46";"4755";"2940";"61,79";3531209
"Monte Alegre do Sul";"2020";"7749";"3863";"3886";"99,41";"4827";"2922";"62,29";3531209
"Monte Alto";"2016";"47811";"23494";"24317";"96,62";"46088";"1723";"96,4";3531308
"Monte Alto";"2017";"47959";"23558";"24401";"96,55";"46294";"1665";"96,53";3531308
"Monte Alto";"2018";"48107";"23622";"24485";"96,48";"46497";"1610";"96,65";3531308
"Monte Alto";"2019";"48256";"23686";"24570";"96,4";"46699";"1557";"96,77";3531308
"Monte Alto";"2020";"48405";"23750";"24655";"96,33";"46900";"1505";"96,89";3531308
"Monte Aprazível";"2016";"22909";"11327";"11582";"97,8";"21153";"1756";"92,33";3531407
"Monte Aprazível";"2017";"23045";"11385";"11660";"97,64";"21313";"1732";"92,48";3531407
"Monte Aprazível";"2018";"23181";"11443";"11738";"97,49";"21470";"1711";"92,62";3531407
"Monte Aprazível";"2019";"23319";"11502";"11817";"97,33";"21626";"1693";"92,74";3531407
"Monte Aprazível";"2020";"23458";"11561";"11897";"97,18";"21781";"1677";"92,85";3531407
"Monte Azul Paulista";"2016";"18481";"9212";"9269";"99,39";"17522";"959";"94,81";3531506
"Monte Azul Paulista";"2017";"18408";"9168";"9240";"99,22";"17482";"926";"94,97";3531506
"Monte Azul Paulista";"2018";"18335";"9124";"9211";"99,06";"17440";"895";"95,12";3531506
"Monte Azul Paulista";"2019";"18263";"9080";"9183";"98,88";"17396";"867";"95,25";3531506
"Monte Azul Paulista";"2020";"18191";"9037";"9154";"98,72";"17350";"841";"95,38";3531506
"Monte Castelo";"2016";"4011";"1973";"2038";"96,81";"3284";"727";"81,87";3531605
"Monte Castelo";"2017";"4007";"1969";"2038";"96,61";"3298";"709";"82,31";3531605
"Monte Castelo";"2018";"4001";"1964";"2037";"96,42";"3311";"690";"82,75";3531605
"Monte Castelo";"2019";"3997";"1960";"2037";"96,22";"3324";"673";"83,16";3531605
"Monte Castelo";"2020";"3991";"1955";"2036";"96,02";"3336";"655";"83,59";3531605
"Monte Mor";"2016";"55313";"27554";"27759";"99,26";"52524";"2789";"94,96";3531803
"Monte Mor";"2017";"56359";"28061";"28298";"99,16";"53600";"2759";"95,1";3531803
"Monte Mor";"2018";"57423";"28576";"28847";"99,06";"54693";"2730";"95,25";3531803
"Monte Mor";"2019";"58508";"29101";"29407";"98,96";"55805";"2703";"95,38";3531803
"Monte Mor";"2020";"59614";"29636";"29978";"98,86";"56936";"2678";"95,51";3531803
"Monteiro Lobato";"2016";"4330";"2238";"2092";"106,98";"1901";"2429";"43,9";3531704
"Monteiro Lobato";"2017";"4364";"2253";"2111";"106,73";"1922";"2442";"44,04";3531704
"Monteiro Lobato";"2018";"4398";"2268";"2130";"106,48";"1942";"2456";"44,16";3531704
"Monteiro Lobato";"2019";"4431";"2282";"2149";"106,19";"1962";"2469";"44,28";3531704
"Monteiro Lobato";"2020";"4465";"2297";"2168";"105,95";"1983";"2482";"44,41";3531704
"Monções";"2016";"2163";"1105";"1058";"104,44";"1878";"285";"86,82";3531001
"Monções";"2017";"2166";"1105";"1061";"104,15";"1883";"283";"86,93";3531001
"Monções";"2018";"2169";"1104";"1065";"103,66";"1888";"281";"87,04";3531001
"Monções";"2019";"2172";"1104";"1068";"103,37";"1893";"279";"87,15";3531001
"Monções";"2020";"2175";"1104";"1071";"103,08";"1898";"277";"87,26";3531001
"Morro Agudo";"2016";"31073";"15815";"15258";"103,65";"30190";"883";"97,16";3531902
"Morro Agudo";"2017";"31383";"15964";"15419";"103,53";"30533";"850";"97,29";3531902
"Morro Agudo";"2018";"31696";"16115";"15581";"103,43";"30875";"821";"97,41";3531902
"Morro Agudo";"2019";"32012";"16267";"15745";"103,32";"31216";"796";"97,51";3531902
"Morro Agudo";"2020";"32332";"16421";"15911";"103,21";"31558";"774";"97,61";3531902
"Morungaba";"2016";"12674";"6329";"6345";"99,75";"11211";"1463";"88,46";3532009
"Morungaba";"2017";"12815";"6396";"6419";"99,64";"11392";"1423";"88,9";3532009
"Morungaba";"2018";"12958";"6464";"6494";"99,54";"11574";"1384";"89,32";3532009
"Morungaba";"2019";"13101";"6532";"6569";"99,44";"11755";"1346";"89,73";3532009
"Morungaba";"2020";"13247";"6601";"6646";"99,32";"11938";"1309";"90,12";3532009
"Motuca";"2016";"4502";"2266";"2236";"101,34";"3473";"1029";"77,14";3532058
"Motuca";"2017";"4536";"2281";"2255";"101,15";"3531";"1005";"77,84";3532058
"Motuca";"2018";"4569";"2296";"2273";"101,01";"3589";"980";"78,55";3532058
"Motuca";"2019";"4604";"2312";"2292";"100,87";"3647";"957";"79,21";3532058
"Motuca";"2020";"4638";"2327";"2311";"100,69";"3705";"933";"79,88";3532058
"Murutinga do Sul";"2016";"4247";"2104";"2143";"98,18";"2610";"1637";"61,46";3532108
"Murutinga do Sul";"2017";"4256";"2106";"2150";"97,95";"2616";"1640";"61,47";3532108
"Murutinga do Sul";"2018";"4264";"2107";"2157";"97,68";"2621";"1643";"61,47";3532108
"Murutinga do Sul";"2019";"4273";"2109";"2164";"97,46";"2626";"1647";"61,46";3532108
"Murutinga do Sul";"2020";"4281";"2110";"2171";"97,19";"2631";"1650";"61,46";3532108
"Nantes";"2016";"2930";"1462";"1468";"99,59";"2757";"173";"94,1";3532157
"Nantes";"2017";"2965";"1478";"1487";"99,39";"2803";"162";"94,54";3532157
"Nantes";"2018";"3000";"1495";"1505";"99,34";"2849";"151";"94,97";3532157
"Nantes";"2019";"3035";"1511";"1524";"99,15";"2893";"142";"95,32";3532157
"Nantes";"2020";"3071";"1528";"1543";"99,03";"2937";"134";"95,64";3532157
"Narandiba";"2016";"4616";"2326";"2290";"101,57";"3603";"1013";"78,05";3532207
"Narandiba";"2017";"4671";"2352";"2319";"101,42";"3686";"985";"78,91";3532207
"Narandiba";"2018";"4727";"2380";"2347";"101,41";"3769";"958";"79,73";3532207
"Narandiba";"2019";"4783";"2407";"2376";"101,3";"3851";"932";"80,51";3532207
"Narandiba";"2020";"4841";"2435";"2406";"101,21";"3935";"906";"81,28";3532207
"Natividade da Serra";"2016";"6683";"3454";"3229";"106,97";"2819";"3864";"42,18";3532306
"Natividade da Serra";"2017";"6687";"3450";"3237";"106,58";"2825";"3862";"42,25";3532306
"Natividade da Serra";"2018";"6690";"3445";"3245";"106,16";"2831";"3859";"42,32";3532306
"Natividade da Serra";"2019";"6694";"3441";"3253";"105,78";"2838";"3856";"42,4";3532306
"Natividade da Serra";"2020";"6698";"3437";"3261";"105,4";"2844";"3854";"42,46";3532306
"Nazaré Paulista";"2016";"17646";"9026";"8620";"104,71";"16630";"1016";"94,24";3532405
"Nazaré Paulista";"2017";"17842";"9117";"8725";"104,49";"16952";"890";"95,01";3532405
"Nazaré Paulista";"2018";"18041";"9209";"8832";"104,27";"17254";"787";"95,64";3532405
"Nazaré Paulista";"2019";"18242";"9302";"8940";"104,05";"17539";"703";"96,15";3532405
"Nazaré Paulista";"2020";"18445";"9396";"9049";"103,83";"17810";"635";"96,56";3532405
"Neves Paulista";"2016";"8697";"4302";"4395";"97,88";"7952";"745";"91,43";3532504
"Neves Paulista";"2017";"8677";"4289";"4388";"97,74";"7948";"729";"91,6";3532504
"Neves Paulista";"2018";"8659";"4277";"4382";"97,6";"7944";"715";"91,74";3532504
"Neves Paulista";"2019";"8639";"4264";"4375";"97,46";"7938";"701";"91,89";3532504
"Neves Paulista";"2020";"8620";"4252";"4368";"97,34";"7932";"688";"92,02";3532504
"Nhandeara";"2016";"10793";"5287";"5506";"96,02";"8946";"1847";"82,89";3532603
"Nhandeara";"2017";"10790";"5282";"5508";"95,9";"8974";"1816";"83,17";3532603
"Nhandeara";"2018";"10787";"5276";"5511";"95,74";"9002";"1785";"83,45";3532603
"Nhandeara";"2019";"10784";"5271";"5513";"95,61";"9030";"1754";"83,74";3532603
"Nhandeara";"2020";"10782";"5266";"5516";"95,47";"9057";"1725";"84";3532603
"Nipoã";"2016";"4720";"2477";"2243";"110,43";"4252";"468";"90,08";3532702
"Nipoã";"2017";"4781";"2506";"2275";"110,15";"4316";"465";"90,27";3532702
"Nipoã";"2018";"4843";"2535";"2308";"109,84";"4380";"463";"90,44";3532702
"Nipoã";"2019";"4905";"2564";"2341";"109,53";"4444";"461";"90,6";3532702
"Nipoã";"2020";"4969";"2594";"2375";"109,22";"4510";"459";"90,76";3532702
"Nova Aliança";"2016";"6237";"3085";"3152";"97,87";"5352";"885";"85,81";3532801
"Nova Aliança";"2017";"6289";"3110";"3179";"97,83";"5423";"866";"86,23";3532801
"Nova Aliança";"2018";"6342";"3135";"3207";"97,75";"5493";"849";"86,61";3532801
"Nova Aliança";"2019";"6396";"3160";"3236";"97,65";"5564";"832";"86,99";3532801
"Nova Aliança";"2020";"6450";"3186";"3264";"97,61";"5635";"815";"87,36";3532801
"Nova Campina";"2016";"9183";"4666";"4517";"103,3";"6893";"2290";"75,06";3532827
"Nova Campina";"2017";"9303";"4724";"4579";"103,17";"7087";"2216";"76,18";3532827
"Nova Campina";"2018";"9425";"4783";"4642";"103,04";"7281";"2144";"77,25";3532827
"Nova Campina";"2019";"9549";"4843";"4706";"102,91";"7476";"2073";"78,29";3532827
"Nova Campina";"2020";"9675";"4904";"4771";"102,79";"7671";"2004";"79,29";3532827
"Nova Canaã Paulista";"2016";"2003";"1013";"990";"102,32";"941";"1062";"46,98";3532843
"Nova Canaã Paulista";"2017";"1987";"1004";"983";"102,14";"951";"1036";"47,86";3532843
"Nova Canaã Paulista";"2018";"1970";"995";"975";"102,05";"960";"1010";"48,73";3532843
"Nova Canaã Paulista";"2019";"1953";"986";"967";"101,96";"969";"984";"49,62";3532843
"Nova Canaã Paulista";"2020";"1937";"977";"960";"101,77";"979";"958";"50,54";3532843
"Nova Castilho";"2016";"1159";"567";"592";"95,78";"869";"290";"74,98";3532868
"Nova Castilho";"2017";"1164";"569";"595";"95,63";"888";"276";"76,29";3532868
"Nova Castilho";"2018";"1167";"570";"597";"95,48";"904";"263";"77,46";3532868
"Nova Castilho";"2019";"1172";"572";"600";"95,33";"922";"250";"78,67";3532868
"Nova Castilho";"2020";"1176";"573";"603";"95,02";"938";"238";"79,76";3532868
"Nova Europa";"2016";"10184";"5046";"5138";"98,21";"9595";"589";"94,22";3532900
"Nova Europa";"2017";"10323";"5109";"5214";"97,99";"9746";"577";"94,41";3532900
"Nova Europa";"2018";"10463";"5172";"5291";"97,75";"9898";"565";"94,6";3532900
"Nova Europa";"2019";"10605";"5235";"5370";"97,49";"10050";"555";"94,77";3532900
"Nova Europa";"2020";"10749";"5300";"5449";"97,27";"10204";"545";"94,93";3532900
"Nova Granada";"2016";"20245";"10175";"10070";"101,04";"18915";"1330";"93,43";3533007
"Nova Granada";"2017";"20411";"10256";"10155";"100,99";"19084";"1327";"93,5";3533007
"Nova Granada";"2018";"20578";"10337";"10241";"100,94";"19253";"1325";"93,56";3533007
"Nova Granada";"2019";"20748";"10420";"10328";"100,89";"19423";"1325";"93,61";3533007
"Nova Granada";"2020";"20918";"10503";"10415";"100,84";"19592";"1326";"93,66";3533007
"Nova Guataporanga";"2016";"2187";"1096";"1091";"100,46";"1941";"246";"88,75";3533106
"Nova Guataporanga";"2017";"2188";"1095";"1093";"100,18";"1948";"240";"89,03";3533106
"Nova Guataporanga";"2018";"2189";"1093";"1096";"99,73";"1955";"234";"89,31";3533106
"Nova Guataporanga";"2019";"2190";"1092";"1098";"99,45";"1962";"228";"89,59";3533106
"Nova Guataporanga";"2020";"2191";"1091";"1100";"99,18";"1969";"222";"89,87";3533106
"Nova Independência";"2016";"3488";"1728";"1760";"98,18";"2898";"590";"83,08";3533205
"Nova Independência";"2017";"3547";"1757";"1790";"98,16";"2965";"582";"83,59";3533205
"Nova Independência";"2018";"3607";"1786";"1821";"98,08";"3033";"574";"84,09";3533205
"Nova Independência";"2019";"3668";"1816";"1852";"98,06";"3102";"566";"84,57";3533205
"Nova Independência";"2020";"3731";"1847";"1884";"98,04";"3172";"559";"85,02";3533205
"Nova Luzitânia";"2016";"3830";"2005";"1825";"109,86";"3533";"297";"92,25";3533304
"Nova Luzitânia";"2017";"3882";"2029";"1853";"109,5";"3594";"288";"92,58";3533304
"Nova Luzitânia";"2018";"3936";"2055";"1881";"109,25";"3657";"279";"92,91";3533304
"Nova Luzitânia";"2019";"3989";"2080";"1909";"108,96";"3719";"270";"93,23";3533304
"Nova Luzitânia";"2020";"4044";"2106";"1938";"108,67";"3782";"262";"93,52";3533304
"Nova Odessa";"2016";"55523";"27452";"28071";"97,79";"54618";"905";"98,37";3533403
"Nova Odessa";"2017";"56142";"27756";"28386";"97,78";"55227";"915";"98,37";3533403
"Nova Odessa";"2018";"56767";"28063";"28704";"97,77";"55842";"925";"98,37";3533403
"Nova Odessa";"2019";"57399";"28373";"29026";"97,75";"56464";"935";"98,37";3533403
"Nova Odessa";"2020";"58039";"28687";"29352";"97,73";"57093";"946";"98,37";3533403
"Novais";"2016";"5174";"2768";"2406";"115,05";"4796";"378";"92,69";3533254
"Novais";"2017";"5256";"2808";"2448";"114,71";"4881";"375";"92,87";3533254
"Novais";"2018";"5339";"2848";"2491";"114,33";"4966";"373";"93,01";3533254
"Novais";"2019";"5423";"2889";"2534";"114,01";"5051";"372";"93,14";3533254
"Novais";"2020";"5509";"2931";"2578";"113,69";"5137";"372";"93,25";3533254
"Novo Horizonte";"2016";"38059";"18948";"19111";"99,15";"35629";"2430";"93,62";3533502
"Novo Horizonte";"2017";"38281";"19051";"19230";"99,07";"35856";"2425";"93,67";3533502
"Novo Horizonte";"2018";"38504";"19155";"19349";"99";"36081";"2423";"93,71";3533502
"Novo Horizonte";"2019";"38728";"19259";"19469";"98,92";"36305";"2423";"93,74";3533502
"Novo Horizonte";"2020";"38954";"19364";"19590";"98,85";"36529";"2425";"93,77";3533502
"Nuporanga";"2016";"7099";"3540";"3559";"99,47";"6668";"431";"93,93";3533601
"Nuporanga";"2017";"7141";"3559";"3582";"99,36";"6736";"405";"94,33";3533601
"Nuporanga";"2018";"7183";"3578";"3605";"99,25";"6801";"382";"94,68";3533601
"Nuporanga";"2019";"7225";"3597";"3628";"99,15";"6864";"361";"95";3533601
"Nuporanga";"2020";"7268";"3616";"3652";"99,01";"6926";"342";"95,29";3533601
"Ocauçu";"2016";"4150";"2111";"2039";"103,53";"3492";"658";"84,14";3533700
"Ocauçu";"2017";"4149";"2107";"2042";"103,18";"3516";"633";"84,74";3533700
"Ocauçu";"2018";"4148";"2103";"2045";"102,84";"3539";"609";"85,32";3533700
"Ocauçu";"2019";"4147";"2099";"2048";"102,49";"3561";"586";"85,87";3533700
"Ocauçu";"2020";"4146";"2095";"2051";"102,15";"3582";"564";"86,4";3533700
"Óleo";"2016";"2572";"1280";"1292";"99,07";"1791";"781";"69,63";3533809
"Óleo";"2017";"2560";"1272";"1288";"98,76";"1798";"762";"70,23";3533809
"Óleo";"2018";"2550";"1265";"1285";"98,44";"1806";"744";"70,82";3533809
"Óleo";"2019";"2538";"1257";"1281";"98,13";"1812";"726";"71,39";3533809
"Óleo";"2020";"2527";"1250";"1277";"97,89";"1818";"709";"71,94";3533809
"Olímpia";"2016";"51598";"25391";"26207";"96,89";"49089";"2509";"95,14";3533908
"Olímpia";"2017";"51826";"25493";"26333";"96,81";"49355";"2471";"95,23";3533908
"Olímpia";"2018";"52055";"25596";"26459";"96,74";"49621";"2434";"95,32";3533908
"Olímpia";"2019";"52285";"25699";"26586";"96,66";"49885";"2400";"95,41";3533908
"Olímpia";"2020";"52516";"25803";"26713";"96,59";"50148";"2368";"95,49";3533908
"Onda Verde";"2016";"4093";"2090";"2003";"104,34";"3389";"704";"82,8";3534005
"Onda Verde";"2017";"4126";"2106";"2020";"104,26";"3442";"684";"83,42";3534005
"Onda Verde";"2018";"4159";"2122";"2037";"104,17";"3495";"664";"84,03";3534005
"Onda Verde";"2019";"4192";"2138";"2054";"104,09";"3546";"646";"84,59";3534005
"Onda Verde";"2020";"4225";"2154";"2071";"104,01";"3597";"628";"85,14";3534005
"Oriente";"2016";"6198";"3021";"3177";"95,09";"5869";"329";"94,69";3534104
"Oriente";"2017";"6215";"3028";"3187";"95,01";"5892";"323";"94,8";3534104
"Oriente";"2018";"6231";"3034";"3197";"94,9";"5914";"317";"94,91";3534104
"Oriente";"2019";"6248";"3041";"3207";"94,82";"5936";"312";"95,01";3534104
"Oriente";"2020";"6265";"3048";"3217";"94,75";"5956";"309";"95,07";3534104
"Orindiúva";"2016";"6421";"3254";"3167";"102,75";"5967";"454";"92,93";3534203
"Orindiúva";"2017";"6529";"3305";"3224";"102,51";"6074";"455";"93,03";3534203
"Orindiúva";"2018";"6640";"3358";"3282";"102,32";"6184";"456";"93,13";3534203
"Orindiúva";"2019";"6752";"3411";"3341";"102,1";"6294";"458";"93,22";3534203
"Orindiúva";"2020";"6866";"3465";"3401";"101,88";"6405";"461";"93,29";3534203
"Orlândia";"2016";"41341";"20243";"21098";"95,95";"40276";"1065";"97,42";3534302
"Orlândia";"2017";"41570";"20353";"21217";"95,93";"40499";"1071";"97,42";3534302
"Orlândia";"2018";"41801";"20464";"21337";"95,91";"40724";"1077";"97,42";3534302
"Orlândia";"2019";"42033";"20575";"21458";"95,88";"40950";"1083";"97,42";3534302
"Orlândia";"2020";"42266";"20687";"21579";"95,87";"41177";"1089";"97,42";3534302
"Osasco";"2016";"674552";"324497";"350055";"92,7";"674552";"-";"100";3534401
"Osasco";"2017";"676149";"325313";"350836";"92,73";"676149";"-";"100";3534401
"Osasco";"2018";"677750";"326131";"351619";"92,75";"677750";"-";"100";3534401
"Osasco";"2019";"679356";"326952";"352404";"92,78";"679356";"-";"100";3534401
"Osasco";"2020";"680964";"327774";"353190";"92,8";"680964";"-";"100";3534401
"Oscar Bressane";"2016";"2522";"1207";"1315";"91,79";"2167";"355";"85,92";3534500
"Oscar Bressane";"2017";"2520";"1206";"1314";"91,78";"2177";"343";"86,39";3534500
"Oscar Bressane";"2018";"2518";"1206";"1312";"91,92";"2186";"332";"86,81";3534500
"Oscar Bressane";"2019";"2516";"1205";"1311";"91,91";"2195";"321";"87,24";3534500
"Oscar Bressane";"2020";"2514";"1204";"1310";"91,91";"2203";"311";"87,63";3534500
"Osvaldo Cruz";"2016";"31159";"15573";"15586";"99,92";"28274";"2885";"90,74";3534609
"Osvaldo Cruz";"2017";"31185";"15573";"15612";"99,75";"28341";"2844";"90,88";3534609
"Osvaldo Cruz";"2018";"31210";"15572";"15638";"99,58";"28406";"2804";"91,02";3534609
"Osvaldo Cruz";"2019";"31236";"15572";"15664";"99,41";"28471";"2765";"91,15";3534609
"Osvaldo Cruz";"2020";"31263";"15573";"15690";"99,25";"28537";"2726";"91,28";3534609
"Ourinhos";"2016";"107616";"52191";"55425";"94,17";"104837";"2779";"97,42";3534708
"Ourinhos";"2017";"108327";"52535";"55792";"94,16";"105529";"2798";"97,42";3534708
"Ourinhos";"2018";"109043";"52881";"56162";"94,16";"106227";"2816";"97,42";3534708
"Ourinhos";"2019";"109763";"53229";"56534";"94,15";"106928";"2835";"97,42";3534708
"Ourinhos";"2020";"110489";"53580";"56909";"94,15";"107635";"2854";"97,42";3534708
"Ouro Verde";"2016";"8082";"3986";"4096";"97,31";"7548";"534";"93,39";3534807
"Ouro Verde";"2017";"8129";"4007";"4122";"97,21";"7608";"521";"93,59";3534807
"Ouro Verde";"2018";"8174";"4027";"4147";"97,11";"7666";"508";"93,79";3534807
"Ouro Verde";"2019";"8221";"4048";"4173";"97";"7725";"496";"93,97";3534807
"Ouro Verde";"2020";"8268";"4069";"4199";"96,9";"7784";"484";"94,15";3534807
"Ouroeste";"2016";"9259";"4589";"4670";"98,27";"8559";"700";"92,44";3534757
"Ouroeste";"2017";"9385";"4648";"4737";"98,12";"8698";"687";"92,68";3534757
"Ouroeste";"2018";"9515";"4709";"4806";"97,98";"8837";"678";"92,87";3534757
"Ouroeste";"2019";"9645";"4770";"4875";"97,85";"8974";"671";"93,04";3534757
"Ouroeste";"2020";"9777";"4832";"4945";"97,71";"9111";"666";"93,19";3534757
"Pacaembu";"2016";"13122";"7653";"5469";"139,93";"9668";"3454";"73,68";3534906
"Pacaembu";"2017";"13105";"7640";"5465";"139,8";"9656";"3449";"73,68";3534906
"Pacaembu";"2018";"13090";"7628";"5462";"139,66";"9645";"3445";"73,68";3534906
"Pacaembu";"2019";"13073";"7615";"5458";"139,52";"9632";"3441";"73,68";3534906
"Pacaembu";"2020";"13056";"7602";"5454";"139,38";"9620";"3436";"73,68";3534906
"Palestina";"2016";"11766";"5933";"5833";"101,71";"9995";"1771";"84,95";3535002
"Palestina";"2017";"11863";"5979";"5884";"101,61";"10110";"1753";"85,22";3535002
"Palestina";"2018";"11962";"6026";"5936";"101,52";"10226";"1736";"85,49";3535002
"Palestina";"2019";"12060";"6072";"5988";"101,4";"10341";"1719";"85,75";3535002
"Palestina";"2020";"12160";"6119";"6041";"101,29";"10458";"1702";"86";3535002
"Palmares Paulista";"2016";"12204";"6491";"5713";"113,62";"11852";"352";"97,12";3535101
"Palmares Paulista";"2017";"12398";"6586";"5812";"113,32";"12041";"357";"97,12";3535101
"Palmares Paulista";"2018";"12594";"6683";"5911";"113,06";"12231";"363";"97,12";3535101
"Palmares Paulista";"2019";"12794";"6781";"6013";"112,77";"12425";"369";"97,12";3535101
"Palmares Paulista";"2020";"12997";"6881";"6116";"112,51";"12623";"374";"97,12";3535101
"Palmeira d'Oeste";"2016";"9276";"4625";"4651";"99,44";"7360";"1916";"79,34";3535200
"Palmeira d'Oeste";"2017";"9239";"4602";"4637";"99,25";"7379";"1860";"79,87";3535200
"Palmeira d'Oeste";"2018";"9203";"4580";"4623";"99,07";"7397";"1806";"80,38";3535200
"Palmeira d'Oeste";"2019";"9166";"4557";"4609";"98,87";"7413";"1753";"80,87";3535200
"Palmeira d'Oeste";"2020";"9130";"4535";"4595";"98,69";"7428";"1702";"81,36";3535200
"Palmital";"2016";"21446";"10451";"10995";"95,05";"20133";"1313";"93,88";3535309
"Palmital";"2017";"21484";"10466";"11018";"94,99";"20215";"1269";"94,09";3535309
"Palmital";"2018";"21523";"10482";"11041";"94,94";"20293";"1230";"94,29";3535309
"Palmital";"2019";"21561";"10497";"11064";"94,88";"20364";"1197";"94,45";3535309
"Palmital";"2020";"21599";"10512";"11087";"94,81";"20431";"1168";"94,59";3535309
"Panorama";"2016";"14957";"7454";"7503";"99,35";"14612";"345";"97,69";3535408
"Panorama";"2017";"15017";"7478";"7539";"99,19";"14677";"340";"97,74";3535408
"Panorama";"2018";"15078";"7502";"7576";"99,02";"14743";"335";"97,78";3535408
"Panorama";"2019";"15138";"7526";"7612";"98,87";"14806";"332";"97,81";3535408
"Panorama";"2020";"15199";"7550";"7649";"98,71";"14870";"329";"97,84";3535408
"Paraguaçu Paulista";"2016";"43447";"21775";"21672";"100,48";"39373";"4074";"90,62";3535507
"Paraguaçu Paulista";"2017";"43629";"21857";"21772";"100,39";"39538";"4091";"90,62";3535507
"Paraguaçu Paulista";"2018";"43812";"21940";"21872";"100,31";"39704";"4108";"90,62";3535507
"Paraguaçu Paulista";"2019";"43996";"22023";"21973";"100,23";"39871";"4125";"90,62";3535507
"Paraguaçu Paulista";"2020";"44180";"22105";"22075";"100,14";"40038";"4142";"90,62";3535507
"Paraibuna";"2016";"17893";"9030";"8863";"101,88";"5394";"12499";"30,15";3535606
"Paraibuna";"2017";"17976";"9062";"8914";"101,66";"5419";"12557";"30,15";3535606
"Paraibuna";"2018";"18060";"9095";"8965";"101,45";"5445";"12615";"30,15";3535606
"Paraibuna";"2019";"18145";"9128";"9017";"101,23";"5470";"12675";"30,15";3535606
"Paraibuna";"2020";"18230";"9161";"9069";"101,01";"5496";"12734";"30,15";3535606
"Paraíso";"2016";"6135";"3122";"3013";"103,62";"5524";"611";"90,04";3535705
"Paraíso";"2017";"6169";"3138";"3031";"103,53";"5572";"597";"90,32";3535705
"Paraíso";"2018";"6202";"3154";"3048";"103,48";"5617";"585";"90,57";3535705
"Paraíso";"2019";"6235";"3169";"3066";"103,36";"5662";"573";"90,81";3535705
"Paraíso";"2020";"6269";"3185";"3084";"103,27";"5706";"563";"91,02";3535705
"Paranapanema";"2016";"19083";"9666";"9417";"102,64";"16089";"2994";"84,31";3535804
"Paranapanema";"2017";"19299";"9768";"9531";"102,49";"16360";"2939";"84,77";3535804
"Paranapanema";"2018";"19517";"9871";"9646";"102,33";"16632";"2885";"85,22";3535804
"Paranapanema";"2019";"19739";"9976";"9763";"102,18";"16907";"2832";"85,65";3535804
"Paranapanema";"2020";"19962";"10081";"9881";"102,02";"17183";"2779";"86,08";3535804
"Paranapuã";"2016";"3866";"1971";"1895";"104,01";"3511";"355";"90,82";3535903
"Paranapuã";"2017";"3873";"1973";"1900";"103,84";"3527";"346";"91,07";3535903
"Paranapuã";"2018";"3879";"1975";"1904";"103,73";"3541";"338";"91,29";3535903
"Paranapuã";"2019";"3886";"1977";"1909";"103,56";"3555";"331";"91,48";3535903
"Paranapuã";"2020";"3892";"1979";"1913";"103,45";"3568";"324";"91,68";3535903
"Parapuã";"2016";"10631";"5392";"5239";"102,92";"9001";"1630";"84,67";3536000
"Parapuã";"2017";"10600";"5372";"5228";"102,75";"9016";"1584";"85,06";3536000
"Parapuã";"2018";"10569";"5352";"5217";"102,59";"9030";"1539";"85,44";3536000
"Parapuã";"2019";"10538";"5332";"5206";"102,42";"9042";"1496";"85,8";3536000
"Parapuã";"2020";"10507";"5312";"5195";"102,25";"9053";"1454";"86,16";3536000
"Pardinho";"2016";"6064";"3069";"2995";"102,47";"5166";"898";"85,19";3536109
"Pardinho";"2017";"6144";"3107";"3037";"102,3";"5289";"855";"86,08";3536109
"Pardinho";"2018";"6226";"3146";"3080";"102,14";"5413";"813";"86,94";3536109
"Pardinho";"2019";"6309";"3185";"3124";"101,95";"5535";"774";"87,73";3536109
"Pardinho";"2020";"6392";"3224";"3168";"101,77";"5657";"735";"88,5";3536109
"Pariquera-Açu";"2016";"18937";"9341";"9596";"97,34";"13236";"5701";"69,89";3536208
"Pariquera-Açu";"2017";"19015";"9374";"9641";"97,23";"13329";"5686";"70,1";3536208
"Pariquera-Açu";"2018";"19094";"9407";"9687";"97,11";"13423";"5671";"70,3";3536208
"Pariquera-Açu";"2019";"19172";"9440";"9732";"97";"13516";"5656";"70,5";3536208
"Pariquera-Açu";"2020";"19251";"9473";"9778";"96,88";"13610";"5641";"70,7";3536208
"Parisi";"2016";"2049";"1042";"1007";"103,48";"1693";"356";"82,63";3536257
"Parisi";"2017";"2050";"1041";"1009";"103,17";"1700";"350";"82,93";3536257
"Parisi";"2018";"2052";"1040";"1012";"102,77";"1707";"345";"83,19";3536257
"Parisi";"2019";"2053";"1039";"1014";"102,47";"1713";"340";"83,44";3536257
"Parisi";"2020";"2054";"1038";"1016";"102,17";"1719";"335";"83,69";3536257
"Patrocínio Paulista";"2016";"13890";"7012";"6878";"101,95";"11596";"2294";"83,48";3536307
"Patrocínio Paulista";"2017";"14031";"7078";"6953";"101,8";"11772";"2259";"83,9";3536307
"Patrocínio Paulista";"2018";"14174";"7144";"7030";"101,62";"11950";"2224";"84,31";3536307
"Patrocínio Paulista";"2019";"14318";"7211";"7107";"101,46";"12128";"2190";"84,7";3536307
"Patrocínio Paulista";"2020";"14463";"7278";"7185";"101,29";"12307";"2156";"85,09";3536307
"Paulicéia";"2016";"6833";"3525";"3308";"106,56";"5947";"886";"87,03";3536406
"Paulicéia";"2017";"6910";"3561";"3349";"106,33";"6053";"857";"87,6";3536406
"Paulicéia";"2018";"6988";"3597";"3391";"106,07";"6158";"830";"88,12";3536406
"Paulicéia";"2019";"7067";"3634";"3433";"105,85";"6263";"804";"88,62";3536406
"Paulicéia";"2020";"7146";"3671";"3475";"105,64";"6368";"778";"89,11";3536406
"Paulínia";"2016";"96955";"47919";"49036";"97,72";"96865";"90";"99,91";3536505
"Paulínia";"2017";"98915";"48873";"50042";"97,66";"98823";"92";"99,91";3536505
"Paulínia";"2018";"100915";"49846";"51069";"97,61";"100822";"93";"99,91";3536505
"Paulínia";"2019";"102956";"50839";"52117";"97,55";"102861";"95";"99,91";3536505
"Paulínia";"2020";"105037";"51851";"53186";"97,49";"104940";"97";"99,91";3536505
"Paulistânia";"2016";"1775";"912";"863";"105,68";"1319";"456";"74,31";3536570
"Paulistânia";"2017";"1774";"911";"863";"105,56";"1335";"439";"75,25";3536570
"Paulistânia";"2018";"1772";"909";"863";"105,33";"1350";"422";"76,19";3536570
"Paulistânia";"2019";"1771";"908";"863";"105,21";"1365";"406";"77,08";3536570
"Paulistânia";"2020";"1769";"906";"863";"104,98";"1379";"390";"77,95";3536570
"Paulo de Faria";"2016";"8534";"4268";"4266";"100,05";"7783";"751";"91,2";3536604
"Paulo de Faria";"2017";"8531";"4266";"4265";"100,02";"7792";"739";"91,34";3536604
"Paulo de Faria";"2018";"8528";"4265";"4263";"100,05";"7800";"728";"91,46";3536604
"Paulo de Faria";"2019";"8525";"4263";"4262";"100,02";"7808";"717";"91,59";3536604
"Paulo de Faria";"2020";"8521";"4261";"4260";"100,02";"7814";"707";"91,7";3536604
"Pederneiras";"2016";"43993";"21990";"22003";"99,94";"40913";"3080";"93";3536703
"Pederneiras";"2017";"44383";"22168";"22215";"99,79";"41276";"3107";"93";3536703
"Pederneiras";"2018";"44775";"22347";"22428";"99,64";"41641";"3134";"93";3536703
"Pederneiras";"2019";"45171";"22527";"22644";"99,48";"42009";"3162";"93";3536703
"Pederneiras";"2020";"45570";"22709";"22861";"99,34";"42380";"3190";"93";3536703
"Pedra Bela";"2016";"5896";"3070";"2826";"108,63";"1600";"4296";"27,14";3536802
"Pedra Bela";"2017";"5912";"3075";"2837";"108,39";"1627";"4285";"27,52";3536802
"Pedra Bela";"2018";"5930";"3081";"2849";"108,14";"1655";"4275";"27,91";3536802
"Pedra Bela";"2019";"5947";"3086";"2861";"107,86";"1683";"4264";"28,3";3536802
"Pedra Bela";"2020";"5964";"3091";"2873";"107,59";"1711";"4253";"28,69";3536802
"Pedranópolis";"2016";"2467";"1266";"1201";"105,41";"1560";"907";"63,23";3536901
"Pedranópolis";"2017";"2455";"1260";"1195";"105,44";"1557";"898";"63,42";3536901
"Pedranópolis";"2018";"2445";"1255";"1190";"105,46";"1555";"890";"63,6";3536901
"Pedranópolis";"2019";"2433";"1249";"1184";"105,49";"1551";"882";"63,75";3536901
"Pedranópolis";"2020";"2422";"1243";"1179";"105,43";"1548";"874";"63,91";3536901
"Pedregulho";"2016";"16057";"8123";"7934";"102,38";"11943";"4114";"74,38";3537008
"Pedregulho";"2017";"16112";"8144";"7968";"102,21";"11999";"4113";"74,47";3537008
"Pedregulho";"2018";"16167";"8166";"8001";"102,06";"12056";"4111";"74,57";3537008
"Pedregulho";"2019";"16223";"8188";"8035";"101,9";"12114";"4109";"74,67";3537008
"Pedregulho";"2020";"16279";"8210";"8069";"101,75";"12172";"4107";"74,77";3537008
"Pedreira";"2016";"44707";"22111";"22596";"97,85";"44332";"375";"99,16";3537107
"Pedreira";"2017";"45161";"22327";"22834";"97,78";"44782";"379";"99,16";3537107
"Pedreira";"2018";"45618";"22544";"23074";"97,7";"45235";"383";"99,16";3537107
"Pedreira";"2019";"46081";"22764";"23317";"97,63";"45694";"387";"99,16";3537107
"Pedreira";"2020";"46548";"22986";"23562";"97,56";"46157";"391";"99,16";3537107
"Pedrinhas Paulista";"2016";"2983";"1480";"1503";"98,47";"2568";"415";"86,09";3537156
"Pedrinhas Paulista";"2017";"2990";"1482";"1508";"98,28";"2582";"408";"86,35";3537156
"Pedrinhas Paulista";"2018";"2997";"1485";"1512";"98,21";"2595";"402";"86,59";3537156
"Pedrinhas Paulista";"2019";"3004";"1487";"1517";"98,02";"2609";"395";"86,85";3537156
"Pedrinhas Paulista";"2020";"3010";"1489";"1521";"97,9";"2621";"389";"87,08";3537156
"Pedro de Toledo";"2016";"10653";"5336";"5317";"100,36";"7457";"3196";"70";3537206
"Pedro de Toledo";"2017";"10734";"5370";"5364";"100,11";"7532";"3202";"70,17";3537206
"Pedro de Toledo";"2018";"10814";"5403";"5411";"99,85";"7607";"3207";"70,34";3537206
"Pedro de Toledo";"2019";"10895";"5437";"5458";"99,62";"7683";"3212";"70,52";3537206
"Pedro de Toledo";"2020";"10977";"5471";"5506";"99,36";"7759";"3218";"70,68";3537206
"Penápolis";"2016";"59953";"29198";"30755";"94,94";"57825";"2128";"96,45";3537305
"Penápolis";"2017";"60157";"29288";"30869";"94,88";"58093";"2064";"96,57";3537305
"Penápolis";"2018";"60362";"29378";"30984";"94,82";"58358";"2004";"96,68";3537305
"Penápolis";"2019";"60568";"29469";"31099";"94,76";"58620";"1948";"96,78";3537305
"Penápolis";"2020";"60774";"29560";"31214";"94,7";"58877";"1897";"96,88";3537305
"Pereira Barreto";"2016";"25237";"12356";"12881";"95,92";"23576";"1661";"93,42";3537404
"Pereira Barreto";"2017";"25276";"12368";"12908";"95,82";"23627";"1649";"93,48";3537404
"Pereira Barreto";"2018";"25314";"12380";"12934";"95,72";"23676";"1638";"93,53";3537404
"Pereira Barreto";"2019";"25352";"12392";"12960";"95,62";"23725";"1627";"93,58";3537404
"Pereira Barreto";"2020";"25391";"12404";"12987";"95,51";"23775";"1616";"93,64";3537404
"Pereiras";"2016";"8056";"4084";"3972";"102,82";"5380";"2676";"66,78";3537503
"Pereiras";"2017";"8147";"4128";"4019";"102,71";"5441";"2706";"66,79";3537503
"Pereiras";"2018";"8240";"4173";"4067";"102,61";"5503";"2737";"66,78";3537503
"Pereiras";"2019";"8333";"4218";"4115";"102,5";"5565";"2768";"66,78";3537503
"Pereiras";"2020";"8428";"4264";"4164";"102,4";"5628";"2800";"66,78";3537503
"Peruíbe";"2016";"63609";"30893";"32716";"94,43";"63117";"492";"99,23";3537602
"Peruíbe";"2017";"64248";"31192";"33056";"94,36";"63780";"468";"99,27";3537602
"Peruíbe";"2018";"64892";"31493";"33399";"94,29";"64447";"445";"99,31";3537602
"Peruíbe";"2019";"65543";"31797";"33746";"94,22";"65120";"423";"99,35";3537602
"Peruíbe";"2020";"66201";"32104";"34097";"94,15";"65798";"403";"99,39";3537602
"Piacatu";"2016";"5656";"2835";"2821";"100,5";"5131";"525";"90,72";3537701
"Piacatu";"2017";"5714";"2862";"2852";"100,35";"5204";"510";"91,07";3537701
"Piacatu";"2018";"5772";"2890";"2882";"100,28";"5276";"496";"91,41";3537701
"Piacatu";"2019";"5832";"2918";"2914";"100,14";"5350";"482";"91,74";3537701
"Piacatu";"2020";"5891";"2946";"2945";"100,03";"5422";"469";"92,04";3537701
"Piedade";"2016";"52927";"26816";"26111";"102,7";"24617";"28310";"46,51";3537800
"Piedade";"2017";"53078";"26868";"26210";"102,51";"24771";"28307";"46,67";3537800
"Piedade";"2018";"53230";"26921";"26309";"102,33";"24926";"28304";"46,83";3537800
"Piedade";"2019";"53383";"26974";"26409";"102,14";"25082";"28301";"46,98";3537800
"Piedade";"2020";"53536";"27027";"26509";"101,95";"25239";"28297";"47,14";3537800
"Pilar do Sul";"2016";"27518";"13916";"13602";"102,31";"22423";"5095";"81,48";3537909
"Pilar do Sul";"2017";"27692";"13995";"13697";"102,18";"22690";"5002";"81,94";3537909
"Pilar do Sul";"2018";"27867";"14074";"13793";"102,04";"22957";"4910";"82,38";3537909
"Pilar do Sul";"2019";"28043";"14154";"13889";"101,91";"23223";"4820";"82,81";3537909
"Pilar do Sul";"2020";"28221";"14235";"13986";"101,78";"23491";"4730";"83,24";3537909
"Pindamonhangaba";"2016";"157459";"77346";"80113";"96,55";"152743";"4716";"97";3538006
"Pindamonhangaba";"2017";"158974";"78071";"80903";"96,5";"154332";"4642";"97,08";3538006
"Pindamonhangaba";"2018";"160506";"78804";"81702";"96,45";"155930";"4576";"97,15";3538006
"Pindamonhangaba";"2019";"162051";"79543";"82508";"96,41";"157534";"4517";"97,21";3538006
"Pindamonhangaba";"2020";"163611";"80289";"83322";"96,36";"159147";"4464";"97,27";3538006
"Pindorama";"2016";"15844";"8059";"7785";"103,52";"14997";"847";"94,65";3538105
"Pindorama";"2017";"15946";"8104";"7842";"103,34";"15094";"852";"94,66";3538105
"Pindorama";"2018";"16049";"8149";"7900";"103,15";"15191";"858";"94,65";3538105
"Pindorama";"2019";"16152";"8194";"7958";"102,97";"15288";"864";"94,65";3538105
"Pindorama";"2020";"16255";"8239";"8016";"102,78";"15386";"869";"94,65";3538105
"Pinhalzinho";"2016";"14119";"7053";"7066";"99,82";"7047";"7072";"49,91";3538204
"Pinhalzinho";"2017";"14275";"7124";"7151";"99,62";"7141";"7134";"50,02";3538204
"Pinhalzinho";"2018";"14433";"7195";"7238";"99,41";"7236";"7197";"50,14";3538204
"Pinhalzinho";"2019";"14593";"7267";"7326";"99,19";"7332";"7261";"50,24";3538204
"Pinhalzinho";"2020";"14755";"7340";"7415";"98,99";"7429";"7326";"50,35";3538204
"Piquerobi";"2016";"3534";"1732";"1802";"96,12";"2760";"774";"78,1";3538303
"Piquerobi";"2017";"3534";"1729";"1805";"95,79";"2774";"760";"78,49";3538303
"Piquerobi";"2018";"3534";"1727";"1807";"95,57";"2789";"745";"78,92";3538303
"Piquerobi";"2019";"3534";"1724";"1810";"95,25";"2803";"731";"79,32";3538303
"Piquerobi";"2020";"3535";"1722";"1813";"94,98";"2818";"717";"79,72";3538303
"Piquete";"2016";"13790";"6670";"7120";"93,68";"12929";"861";"93,76";3538501
"Piquete";"2017";"13754";"6653";"7101";"93,69";"12898";"856";"93,78";3538501
"Piquete";"2018";"13718";"6636";"7082";"93,7";"12866";"852";"93,79";3538501
"Piquete";"2019";"13683";"6619";"7064";"93,7";"12836";"847";"93,81";3538501
"Piquete";"2020";"13647";"6602";"7045";"93,71";"12804";"843";"93,82";3538501
"Piracaia";"2016";"25811";"12795";"13016";"98,3";"25811";"-";"100";3538600
"Piracaia";"2017";"25929";"12845";"13084";"98,17";"25929";"-";"100";3538600
"Piracaia";"2018";"26048";"12895";"13153";"98,04";"26048";"-";"100";3538600
"Piracaia";"2019";"26167";"12945";"13222";"97,91";"26167";"-";"100";3538600
"Piracaia";"2020";"26287";"12996";"13291";"97,78";"26287";"-";"100";3538600
"Piracicaba";"2016";"380494";"185983";"194511";"95,62";"373282";"7212";"98,1";3538709
"Piracicaba";"2017";"382817";"187091";"195726";"95,59";"375654";"7163";"98,13";3538709
"Piracicaba";"2018";"385155";"188206";"196949";"95,56";"378029";"7126";"98,15";3538709
"Piracicaba";"2019";"387507";"189328";"198179";"95,53";"380407";"7100";"98,17";3538709
"Piracicaba";"2020";"389873";"190456";"199417";"95,51";"382790";"7083";"98,18";3538709
"Piraju";"2016";"28568";"13848";"14720";"94,08";"26085";"2483";"91,31";3538808
"Piraju";"2017";"28569";"13845";"14724";"94,03";"26147";"2422";"91,52";3538808
"Piraju";"2018";"28571";"13842";"14729";"93,98";"26207";"2364";"91,73";3538808
"Piraju";"2019";"28572";"13839";"14733";"93,93";"26266";"2306";"91,93";3538808
"Piraju";"2020";"28574";"13836";"14738";"93,88";"26324";"2250";"92,13";3538808
"Pirajuí";"2016";"23140";"12634";"10506";"120,26";"18929";"4211";"81,8";3538907
"Pirajuí";"2017";"23169";"12647";"10522";"120,2";"18965";"4204";"81,86";3538907
"Pirajuí";"2018";"23199";"12661";"10538";"120,15";"19002";"4197";"81,91";3538907
"Pirajuí";"2019";"23228";"12674";"10554";"120,09";"19038";"4190";"81,96";3538907
"Pirajuí";"2020";"23259";"12689";"10570";"120,05";"19075";"4184";"82,01";3538907
"Pirangi";"2016";"10760";"5421";"5339";"101,54";"9806";"954";"91,13";3539004
"Pirangi";"2017";"10775";"5423";"5352";"101,33";"9843";"932";"91,35";3539004
"Pirangi";"2018";"10792";"5426";"5366";"101,12";"9881";"911";"91,56";3539004
"Pirangi";"2019";"10807";"5428";"5379";"100,91";"9916";"891";"91,76";3539004
"Pirangi";"2020";"10823";"5430";"5393";"100,69";"9951";"872";"91,94";3539004
"Pirapora do Bom Jesus";"2016";"17548";"8671";"8877";"97,68";"17548";"-";"100";3539103
"Pirapora do Bom Jesus";"2017";"17865";"8821";"9044";"97,53";"17865";"-";"100";3539103
"Pirapora do Bom Jesus";"2018";"18188";"8974";"9214";"97,4";"18188";"-";"100";3539103
"Pirapora do Bom Jesus";"2019";"18516";"9129";"9387";"97,25";"18516";"-";"100";3539103
"Pirapora do Bom Jesus";"2020";"18851";"9287";"9564";"97,1";"18851";"-";"100";3539103
"Pirapozinho";"2016";"26215";"12799";"13416";"95,4";"25060";"1155";"95,59";3539202
"Pirapozinho";"2017";"26461";"12916";"13545";"95,36";"25318";"1143";"95,68";3539202
"Pirapozinho";"2018";"26709";"13035";"13674";"95,33";"25577";"1132";"95,76";3539202
"Pirapozinho";"2019";"26960";"13155";"13805";"95,29";"25839";"1121";"95,84";3539202
"Pirapozinho";"2020";"27213";"13276";"13937";"95,26";"26103";"1110";"95,92";3539202
"Pirassununga";"2016";"72356";"35329";"37027";"95,41";"67243";"5113";"92,93";3539301
"Pirassununga";"2017";"72691";"35480";"37211";"95,35";"67695";"4996";"93,13";3539301
"Pirassununga";"2018";"73027";"35631";"37396";"95,28";"68143";"4884";"93,31";3539301
"Pirassununga";"2019";"73366";"35784";"37582";"95,22";"68591";"4775";"93,49";3539301
"Pirassununga";"2020";"73706";"35937";"37769";"95,15";"69037";"4669";"93,67";3539301
"Piratininga";"2016";"12764";"6304";"6460";"97,59";"11088";"1676";"86,87";3539400
"Piratininga";"2017";"12875";"6356";"6519";"97,5";"11207";"1668";"87,04";3539400
"Piratininga";"2018";"12987";"6408";"6579";"97,4";"11328";"1659";"87,23";3539400
"Piratininga";"2019";"13100";"6461";"6639";"97,32";"11449";"1651";"87,4";3539400
"Piratininga";"2020";"13213";"6514";"6699";"97,24";"11570";"1643";"87,57";3539400
"Pitangueiras";"2016";"37295";"18952";"18343";"103,32";"36185";"1110";"97,02";3539509
"Pitangueiras";"2017";"37613";"19103";"18510";"103,2";"36540";"1073";"97,15";3539509
"Pitangueiras";"2018";"37934";"19255";"18679";"103,08";"36897";"1037";"97,27";3539509
"Pitangueiras";"2019";"38258";"19408";"18850";"102,96";"37255";"1003";"97,38";3539509
"Pitangueiras";"2020";"38584";"19562";"19022";"102,84";"37614";"970";"97,49";3539509
"Planalto";"2016";"4897";"2527";"2370";"106,62";"4274";"623";"87,28";3539608
"Planalto";"2017";"4964";"2560";"2404";"106,49";"4352";"612";"87,67";3539608
"Planalto";"2018";"5031";"2593";"2438";"106,36";"4430";"601";"88,05";3539608
"Planalto";"2019";"5098";"2626";"2472";"106,23";"4507";"591";"88,41";3539608
"Planalto";"2020";"5167";"2660";"2507";"106,1";"4585";"582";"88,74";3539608
"Platina";"2016";"3378";"1746";"1632";"106,99";"2743";"635";"81,2";3539707
"Platina";"2017";"3408";"1760";"1648";"106,8";"2780";"628";"81,57";3539707
"Platina";"2018";"3439";"1775";"1664";"106,67";"2818";"621";"81,94";3539707
"Platina";"2019";"3470";"1790";"1680";"106,55";"2856";"614";"82,31";3539707
"Platina";"2020";"3501";"1805";"1696";"106,43";"2894";"607";"82,66";3539707
"Poá";"2016";"111929";"54281";"57648";"94,16";"110161";"1768";"98,42";3539806
"Poá";"2017";"112820";"54729";"58091";"94,21";"111037";"1783";"98,42";3539806
"Poá";"2018";"113719";"55181";"58538";"94,27";"111922";"1797";"98,42";3539806
"Poá";"2019";"114625";"55637";"58988";"94,32";"112814";"1811";"98,42";3539806
"Poá";"2020";"115538";"56096";"59442";"94,37";"113713";"1825";"98,42";3539806
"Poloni";"2016";"5562";"2742";"2820";"97,23";"4951";"611";"89,01";3539905
"Poloni";"2017";"5589";"2754";"2835";"97,14";"4975";"614";"89,01";3539905
"Poloni";"2018";"5615";"2765";"2850";"97,02";"4998";"617";"89,01";3539905
"Poloni";"2019";"5641";"2777";"2864";"96,96";"5021";"620";"89,01";3539905
"Poloni";"2020";"5667";"2788";"2879";"96,84";"5044";"623";"89,01";3539905
"Pompéia";"2016";"20775";"10184";"10591";"96,16";"19425";"1350";"93,5";3540002
"Pompéia";"2017";"20901";"10245";"10656";"96,14";"19557";"1344";"93,57";3540002
"Pompéia";"2018";"21027";"10306";"10721";"96,13";"19689";"1338";"93,64";3540002
"Pompéia";"2019";"21154";"10367";"10787";"96,11";"19821";"1333";"93,7";3540002
"Pompéia";"2020";"21282";"10429";"10853";"96,09";"19954";"1328";"93,76";3540002
"Pongaí";"2016";"3385";"1721";"1664";"103,43";"2931";"454";"86,59";3540101
"Pongaí";"2017";"3376";"1713";"1663";"103,01";"2936";"440";"86,97";3540101
"Pongaí";"2018";"3368";"1706";"1662";"102,65";"2942";"426";"87,35";3540101
"Pongaí";"2019";"3359";"1698";"1661";"102,23";"2946";"413";"87,7";3540101
"Pongaí";"2020";"3351";"1691";"1660";"101,87";"2951";"400";"88,06";3540101
"Pontal";"2016";"46092";"24408";"21684";"112,56";"45502";"590";"98,72";3540200
"Pontal";"2017";"46869";"24789";"22080";"112,27";"46304";"565";"98,79";3540200
"Pontal";"2018";"47661";"25177";"22484";"111,98";"47120";"541";"98,86";3540200
"Pontal";"2019";"48465";"25570";"22895";"111,68";"47945";"520";"98,93";3540200
"Pontal";"2020";"49283";"25970";"23313";"111,4";"48784";"499";"98,99";3540200
"Pontalinda";"2016";"4333";"2276";"2057";"110,65";"3727";"606";"86,01";3540259
"Pontalinda";"2017";"4370";"2293";"2077";"110,4";"3777";"593";"86,43";3540259
"Pontalinda";"2018";"4409";"2311";"2098";"110,15";"3828";"581";"86,82";3540259
"Pontalinda";"2019";"4448";"2328";"2120";"109,81";"3879";"569";"87,21";3540259
"Pontalinda";"2020";"4487";"2346";"2141";"109,57";"3929";"558";"87,56";3540259
"Pontes Gestal";"2016";"2522";"1244";"1278";"97,34";"2205";"317";"87,43";3540309
"Pontes Gestal";"2017";"2524";"1243";"1281";"97,03";"2217";"307";"87,84";3540309
"Pontes Gestal";"2018";"2524";"1241";"1283";"96,73";"2227";"297";"88,23";3540309
"Pontes Gestal";"2019";"2526";"1240";"1286";"96,42";"2238";"288";"88,6";3540309
"Pontes Gestal";"2020";"2528";"1239";"1289";"96,12";"2249";"279";"88,96";3540309
"Populina";"2016";"4079";"2044";"2035";"100,44";"3374";"705";"82,72";3540408
"Populina";"2017";"4058";"2031";"2027";"100,2";"3369";"689";"83,02";3540408
"Populina";"2018";"4037";"2017";"2020";"99,85";"3363";"674";"83,3";3540408
"Populina";"2019";"4015";"2003";"2012";"99,55";"3356";"659";"83,59";3540408
"Populina";"2020";"3995";"1990";"2005";"99,25";"3351";"644";"83,88";3540408
"Porangaba";"2016";"8939";"4548";"4391";"103,58";"4316";"4623";"48,28";3540507
"Porangaba";"2017";"9031";"4589";"4442";"103,31";"4360";"4671";"48,28";3540507
"Porangaba";"2018";"9122";"4629";"4493";"103,03";"4404";"4718";"48,28";3540507
"Porangaba";"2019";"9215";"4670";"4545";"102,75";"4449";"4766";"48,28";3540507
"Porangaba";"2020";"9310";"4712";"4598";"102,48";"4495";"4815";"48,28";3540507
"Porto Feliz";"2016";"50607";"25317";"25290";"100,11";"43490";"7117";"85,94";3540606
"Porto Feliz";"2017";"50877";"25441";"25436";"100,02";"43871";"7006";"86,23";3540606
"Porto Feliz";"2018";"51149";"25566";"25583";"99,93";"44253";"6896";"86,52";3540606
"Porto Feliz";"2019";"51422";"25691";"25731";"99,84";"44635";"6787";"86,8";3540606
"Porto Feliz";"2020";"51697";"25817";"25880";"99,76";"45016";"6681";"87,08";3540606
"Porto Ferreira";"2016";"53117";"26255";"26862";"97,74";"52164";"953";"98,21";3540705
"Porto Ferreira";"2017";"53361";"26363";"26998";"97,65";"52404";"957";"98,21";3540705
"Porto Ferreira";"2018";"53607";"26472";"27135";"97,56";"52645";"962";"98,21";3540705
"Porto Ferreira";"2019";"53854";"26581";"27273";"97,46";"52888";"966";"98,21";3540705
"Porto Ferreira";"2020";"54102";"26691";"27411";"97,37";"53132";"970";"98,21";3540705
"Potim";"2016";"20171";"11314";"8857";"127,74";"15296";"4875";"75,83";3540754
"Potim";"2017";"20303";"11374";"8929";"127,38";"15396";"4907";"75,83";3540754
"Potim";"2018";"20434";"11433";"9001";"127,02";"15495";"4939";"75,83";3540754
"Potim";"2019";"20568";"11494";"9074";"126,67";"15597";"4971";"75,83";3540754
"Potim";"2020";"20702";"11555";"9147";"126,33";"15699";"5003";"75,83";3540754
"Potirendaba";"2016";"16194";"8212";"7982";"102,88";"14791";"1403";"91,34";3540804
"Potirendaba";"2017";"16296";"8261";"8035";"102,81";"14915";"1381";"91,53";3540804
"Potirendaba";"2018";"16398";"8310";"8088";"102,74";"15037";"1361";"91,7";3540804
"Potirendaba";"2019";"16501";"8359";"8142";"102,67";"15158";"1343";"91,86";3540804
"Potirendaba";"2020";"16605";"8409";"8196";"102,6";"15278";"1327";"92,01";3540804
"Pracinha";"2016";"2885";"2081";"804";"258,83";"1382";"1503";"47,9";3540853
"Pracinha";"2017";"2893";"2085";"808";"258,04";"1386";"1507";"47,91";3540853
"Pracinha";"2018";"2899";"2088";"811";"257,46";"1389";"1510";"47,91";3540853
"Pracinha";"2019";"2907";"2092";"815";"256,69";"1392";"1515";"47,88";3540853
"Pracinha";"2020";"2913";"2094";"819";"255,68";"1395";"1518";"47,89";3540853
"Pradópolis";"2016";"19609";"9970";"9639";"103,43";"18243";"1366";"93,03";3540903
"Pradópolis";"2017";"19925";"10122";"9803";"103,25";"18549";"1376";"93,09";3540903
"Pradópolis";"2018";"20248";"10277";"9971";"103,07";"18862";"1386";"93,15";3540903
"Pradópolis";"2019";"20575";"10434";"10141";"102,89";"19180";"1395";"93,22";3540903
"Pradópolis";"2020";"20907";"10593";"10314";"102,71";"19502";"1405";"93,28";3540903
"Praia Grande";"2016";"295928";"142069";"153859";"92,34";"295928";"-";"100";3541000
"Praia Grande";"2017";"301024";"144511";"156513";"92,33";"301024";"-";"100";3541000
"Praia Grande";"2018";"306207";"146994";"159213";"92,33";"306207";"-";"100";3541000
"Praia Grande";"2019";"311480";"149521";"161959";"92,32";"311480";"-";"100";3541000
"Praia Grande";"2020";"316844";"152091";"164753";"92,31";"316844";"-";"100";3541000
"Pratânia";"2016";"4926";"2539";"2387";"106,37";"3909";"1017";"79,35";3541059
"Pratânia";"2017";"4983";"2567";"2416";"106,25";"3982";"1001";"79,91";3541059
"Pratânia";"2018";"5040";"2595";"2445";"106,13";"4055";"985";"80,46";3541059
"Pratânia";"2019";"5098";"2623";"2475";"105,98";"4129";"969";"80,99";3541059
"Pratânia";"2020";"5156";"2651";"2505";"105,83";"4203";"953";"81,52";3541059
"Presidente Alves";"2016";"4052";"2004";"2048";"97,85";"3495";"557";"86,25";3541109
"Presidente Alves";"2017";"4044";"2000";"2044";"97,85";"3507";"537";"86,72";3541109
"Presidente Alves";"2018";"4036";"1997";"2039";"97,94";"3517";"519";"87,14";3541109
"Presidente Alves";"2019";"4028";"1993";"2035";"97,94";"3527";"501";"87,56";3541109
"Presidente Alves";"2020";"4020";"1990";"2030";"98,03";"3537";"483";"87,99";3541109
"Presidente Bernardes";"2016";"13679";"6700";"6979";"96";"11131";"2548";"81,37";3541208
"Presidente Bernardes";"2017";"13689";"6698";"6991";"95,81";"11221";"2468";"81,97";3541208
"Presidente Bernardes";"2018";"13700";"6697";"7003";"95,63";"11310";"2390";"82,55";3541208
"Presidente Bernardes";"2019";"13710";"6695";"7015";"95,44";"11396";"2314";"83,12";3541208
"Presidente Bernardes";"2020";"13720";"6693";"7027";"95,25";"11480";"2240";"83,67";3541208
"Presidente Epitácio";"2016";"41947";"20443";"21504";"95,07";"39306";"2641";"93,7";3541307
"Presidente Epitácio";"2017";"42060";"20488";"21572";"94,97";"39439";"2621";"93,77";3541307
"Presidente Epitácio";"2018";"42174";"20533";"21641";"94,88";"39573";"2601";"93,83";3541307
"Presidente Epitácio";"2019";"42286";"20577";"21709";"94,79";"39705";"2581";"93,9";3541307
"Presidente Epitácio";"2020";"42400";"20622";"21778";"94,69";"39839";"2561";"93,96";3541307
"Presidente Prudente";"2016";"216044";"103885";"112159";"92,62";"211637";"4407";"97,96";3541406
"Presidente Prudente";"2017";"217290";"104477";"112813";"92,61";"212858";"4432";"97,96";3541406
"Presidente Prudente";"2018";"218544";"105073";"113471";"92,6";"214086";"4458";"97,96";3541406
"Presidente Prudente";"2019";"219805";"105672";"114133";"92,59";"215321";"4484";"97,96";3541406
"Presidente Prudente";"2020";"221073";"106275";"114798";"92,58";"216563";"4510";"97,96";3541406
"Presidente Venceslau";"2016";"37995";"18939";"19056";"99,39";"36711";"1284";"96,62";3541505
"Presidente Venceslau";"2017";"37997";"18940";"19057";"99,39";"36756";"1241";"96,73";3541505
"Presidente Venceslau";"2018";"38000";"18942";"19058";"99,39";"36799";"1201";"96,84";3541505
"Presidente Venceslau";"2019";"38002";"18943";"19059";"99,39";"36837";"1165";"96,93";3541505
"Presidente Venceslau";"2020";"38005";"18945";"19060";"99,4";"36873";"1132";"97,02";3541505
"Promissão";"2016";"38094";"18882";"19212";"98,28";"32504";"5590";"85,33";3541604
"Promissão";"2017";"38481";"19063";"19418";"98,17";"32898";"5583";"85,49";3541604
"Promissão";"2018";"38873";"19246";"19627";"98,06";"33297";"5576";"85,66";3541604
"Promissão";"2019";"39268";"19431";"19837";"97,95";"33699";"5569";"85,82";3541604
"Promissão";"2020";"39667";"19617";"20050";"97,84";"34106";"5561";"85,98";3541604
"Quadra";"2016";"3526";"1841";"1685";"109,26";"909";"2617";"25,78";3541653
"Quadra";"2017";"3571";"1862";"1709";"108,95";"922";"2649";"25,82";3541653
"Quadra";"2018";"3616";"1882";"1734";"108,54";"934";"2682";"25,83";3541653
"Quadra";"2019";"3662";"1903";"1759";"108,19";"947";"2715";"25,86";3541653
"Quadra";"2020";"3708";"1924";"1784";"107,85";"960";"2748";"25,89";3541653
"Quatá";"2016";"13488";"6717";"6771";"99,2";"12768";"720";"94,66";3541703
"Quatá";"2017";"13599";"6770";"6829";"99,14";"12885";"714";"94,75";3541703
"Quatá";"2018";"13710";"6823";"6887";"99,07";"13002";"708";"94,84";3541703
"Quatá";"2019";"13822";"6877";"6945";"99,02";"13118";"704";"94,91";3541703
"Quatá";"2020";"13935";"6931";"7004";"98,96";"13234";"701";"94,97";3541703
"Queiroz";"2016";"3089";"1569";"1520";"103,22";"2727";"362";"88,28";3541802
"Queiroz";"2017";"3136";"1593";"1543";"103,24";"2782";"354";"88,71";3541802
"Queiroz";"2018";"3183";"1617";"1566";"103,26";"2838";"345";"89,16";3541802
"Queiroz";"2019";"3230";"1641";"1589";"103,27";"2893";"337";"89,57";3541802
"Queiroz";"2020";"3279";"1666";"1613";"103,29";"2949";"330";"89,94";3541802
"Queluz";"2016";"12168";"6187";"5981";"103,44";"9980";"2188";"82,02";3541901
"Queluz";"2017";"12285";"6245";"6040";"103,39";"10075";"2210";"82,01";3541901
"Queluz";"2018";"12404";"6304";"6100";"103,34";"10173";"2231";"82,01";3541901
"Queluz";"2019";"12523";"6363";"6160";"103,3";"10271";"2252";"82,02";3541901
"Queluz";"2020";"12644";"6423";"6221";"103,25";"10370";"2274";"82,02";3541901
"Quintana";"2016";"6307";"3113";"3194";"97,46";"5809";"498";"92,1";3542008
"Quintana";"2017";"6355";"3135";"3220";"97,36";"5858";"497";"92,18";3542008
"Quintana";"2018";"6403";"3157";"3246";"97,26";"5908";"495";"92,27";3542008
"Quintana";"2019";"6451";"3179";"3272";"97,16";"5958";"493";"92,36";3542008
"Quintana";"2020";"6500";"3202";"3298";"97,09";"6009";"491";"92,45";3542008
"Rafard";"2016";"8810";"4351";"4459";"97,58";"7874";"936";"89,38";3542107
"Rafard";"2017";"8852";"4371";"4481";"97,55";"7929";"923";"89,57";3542107
"Rafard";"2018";"8893";"4391";"4502";"97,53";"7982";"911";"89,76";3542107
"Rafard";"2019";"8934";"4410";"4524";"97,48";"8035";"899";"89,94";3542107
"Rafard";"2020";"8976";"4430";"4546";"97,45";"8089";"887";"90,12";3542107
"Rancharia";"2016";"28809";"14112";"14697";"96,02";"26225";"2584";"91,03";3542206
"Rancharia";"2017";"28818";"14111";"14707";"95,95";"26293";"2525";"91,24";3542206
"Rancharia";"2018";"28828";"14111";"14717";"95,88";"26359";"2469";"91,44";3542206
"Rancharia";"2019";"28837";"14110";"14727";"95,81";"26424";"2413";"91,63";3542206
"Rancharia";"2020";"28847";"14110";"14737";"95,75";"26488";"2359";"91,82";3542206
"Redenção da Serra";"2016";"3845";"1989";"1856";"107,17";"2563";"1282";"66,66";3542305
"Redenção da Serra";"2017";"3843";"1986";"1857";"106,95";"2618";"1225";"68,12";3542305
"Redenção da Serra";"2018";"3841";"1983";"1858";"106,73";"2671";"1170";"69,54";3542305
"Redenção da Serra";"2019";"3839";"1980";"1859";"106,51";"2723";"1116";"70,93";3542305
"Redenção da Serra";"2020";"3837";"1977";"1860";"106,29";"2773";"1064";"72,27";3542305
"Regente Feijó";"2016";"19109";"9450";"9659";"97,84";"17826";"1283";"93,29";3542404
"Regente Feijó";"2017";"19203";"9490";"9713";"97,7";"17944";"1259";"93,44";3542404
"Regente Feijó";"2018";"19298";"9531";"9767";"97,58";"18063";"1235";"93,6";3542404
"Regente Feijó";"2019";"19395";"9573";"9822";"97,46";"18184";"1211";"93,76";3542404
"Regente Feijó";"2020";"19491";"9614";"9877";"97,34";"18302";"1189";"93,9";3542404
"Reginópolis";"2016";"7249";"4612";"2637";"174,9";"4318";"2931";"59,57";3542503
"Reginópolis";"2017";"7241";"4606";"2635";"174,8";"4313";"2928";"59,56";3542503
"Reginópolis";"2018";"7232";"4600";"2632";"174,77";"4308";"2924";"59,57";3542503
"Reginópolis";"2019";"7224";"4594";"2630";"174,68";"4303";"2921";"59,57";3542503
"Reginópolis";"2020";"7215";"4588";"2627";"174,65";"4298";"2917";"59,57";3542503
"Registro";"2016";"54050";"26493";"27557";"96,14";"47982";"6068";"88,77";3542602
"Registro";"2017";"54091";"26503";"27588";"96,07";"48018";"6073";"88,77";3542602
"Registro";"2018";"54133";"26514";"27619";"96";"48055";"6078";"88,77";3542602
"Registro";"2019";"54174";"26524";"27650";"95,93";"48092";"6082";"88,77";3542602
"Registro";"2020";"54216";"26535";"27681";"95,86";"48129";"6087";"88,77";3542602
"Restinga";"2016";"7129";"3563";"3566";"99,92";"5773";"1356";"80,98";3542701
"Restinga";"2017";"7218";"3607";"3611";"99,89";"5872";"1346";"81,35";3542701
"Restinga";"2018";"7309";"3652";"3657";"99,86";"5973";"1336";"81,72";3542701
"Restinga";"2019";"7401";"3697";"3704";"99,81";"6074";"1327";"82,07";3542701
"Restinga";"2020";"7493";"3742";"3751";"99,76";"6176";"1317";"82,42";3542701
"Ribeira";"2016";"3272";"1677";"1595";"105,14";"1377";"1895";"42,08";3542800
"Ribeira";"2017";"3264";"1670";"1594";"104,77";"1404";"1860";"43,01";3542800
"Ribeira";"2018";"3257";"1663";"1594";"104,33";"1430";"1827";"43,91";3542800
"Ribeira";"2019";"3249";"1656";"1593";"103,95";"1456";"1793";"44,81";3542800
"Ribeira";"2020";"3242";"1649";"1593";"103,52";"1483";"1759";"45,74";3542800
"Ribeirão Bonito";"2016";"12625";"6333";"6292";"100,65";"11858";"767";"93,92";3542909
"Ribeirão Bonito";"2017";"12707";"6371";"6336";"100,55";"11960";"747";"94,12";3542909
"Ribeirão Bonito";"2018";"12791";"6409";"6382";"100,42";"12062";"729";"94,3";3542909
"Ribeirão Bonito";"2019";"12874";"6447";"6427";"100,31";"12163";"711";"94,48";3542909
"Ribeirão Bonito";"2020";"12959";"6486";"6473";"100,2";"12265";"694";"94,64";3542909
"Ribeirão Branco";"2016";"17736";"9102";"8634";"105,42";"9930";"7806";"55,99";3543006
"Ribeirão Branco";"2017";"17723";"9090";"8633";"105,29";"10072";"7651";"56,83";3543006
"Ribeirão Branco";"2018";"17710";"9079";"8631";"105,19";"10214";"7496";"57,67";3543006
"Ribeirão Branco";"2019";"17697";"9067";"8630";"105,06";"10354";"7343";"58,51";3543006
"Ribeirão Branco";"2020";"17685";"9056";"8629";"104,95";"10493";"7192";"59,33";3543006
"Ribeirão Corrente";"2016";"4511";"2323";"2188";"106,17";"3677";"834";"81,51";3543105
"Ribeirão Corrente";"2017";"4548";"2339";"2209";"105,89";"3722";"826";"81,84";3543105
"Ribeirão Corrente";"2018";"4587";"2356";"2231";"105,6";"3768";"819";"82,15";3543105
"Ribeirão Corrente";"2019";"4625";"2373";"2252";"105,37";"3814";"811";"82,46";3543105
"Ribeirão Corrente";"2020";"4664";"2390";"2274";"105,1";"3860";"804";"82,76";3543105
"Ribeirão do Sul";"2016";"4383";"2187";"2196";"99,59";"3468";"915";"79,12";3543204
"Ribeirão do Sul";"2017";"4378";"2183";"2195";"99,45";"3496";"882";"79,85";3543204
"Ribeirão do Sul";"2018";"4371";"2178";"2193";"99,32";"3522";"849";"80,58";3543204
"Ribeirão do Sul";"2019";"4366";"2174";"2192";"99,18";"3548";"818";"81,26";3543204
"Ribeirão do Sul";"2020";"4360";"2169";"2191";"99";"3572";"788";"81,93";3543204
"Ribeirão dos Índios";"2016";"2156";"1066";"1090";"97,8";"1879";"277";"87,15";3543238
"Ribeirão dos Índios";"2017";"2153";"1063";"1090";"97,52";"1885";"268";"87,55";3543238
"Ribeirão dos Índios";"2018";"2148";"1059";"1089";"97,25";"1888";"260";"87,9";3543238
"Ribeirão dos Índios";"2019";"2145";"1056";"1089";"96,97";"1893";"252";"88,25";3543238
"Ribeirão dos Índios";"2020";"2141";"1053";"1088";"96,78";"1897";"244";"88,6";3543238
"Ribeirão Grande";"2016";"7475";"3789";"3686";"102,79";"2366";"5109";"31,65";3543253
"Ribeirão Grande";"2017";"7483";"3789";"3694";"102,57";"2370";"5113";"31,67";3543253
"Ribeirão Grande";"2018";"7493";"3790";"3703";"102,35";"2374";"5119";"31,68";3543253
"Ribeirão Grande";"2019";"7501";"3790";"3711";"102,13";"2377";"5124";"31,69";3543253
"Ribeirão Grande";"2020";"7510";"3790";"3720";"101,88";"2381";"5129";"31,7";3543253
"Ribeirão Pires";"2016";"116875";"57166";"59709";"95,74";"116875";"-";"100";3543303
"Ribeirão Pires";"2017";"117395";"57413";"59982";"95,72";"117395";"-";"100";3543303
"Ribeirão Pires";"2018";"117917";"57660";"60257";"95,69";"117917";"-";"100";3543303
"Ribeirão Pires";"2019";"118441";"57908";"60533";"95,66";"118441";"-";"100";3543303
"Ribeirão Pires";"2020";"118968";"58158";"60810";"95,64";"118968";"-";"100";3543303
"Ribeirão Preto";"2016";"654893";"314711";"340182";"92,51";"653035";"1858";"99,72";3543402
"Ribeirão Preto";"2017";"661997";"318201";"343796";"92,56";"660118";"1879";"99,72";3543402
"Ribeirão Preto";"2018";"669180";"321731";"347449";"92,6";"667281";"1899";"99,72";3543402
"Ribeirão Preto";"2019";"676440";"325300";"351140";"92,64";"674520";"1920";"99,72";3543402
"Ribeirão Preto";"2020";"683777";"328906";"354871";"92,68";"681837";"1940";"99,72";3543402
"Rifaina";"2016";"3454";"1728";"1726";"100,12";"3049";"405";"88,27";3543600
"Rifaina";"2017";"3458";"1729";"1729";"100";"3057";"401";"88,4";3543600
"Rifaina";"2018";"3460";"1729";"1731";"99,88";"3063";"397";"88,53";3543600
"Rifaina";"2019";"3464";"1730";"1734";"99,77";"3071";"393";"88,65";3543600
"Rifaina";"2020";"3468";"1731";"1737";"99,65";"3078";"390";"88,75";3543600
"Rincão";"2016";"10456";"5247";"5209";"100,73";"8572";"1884";"81,98";3543709
"Rincão";"2017";"10466";"5250";"5216";"100,65";"8593";"1873";"82,1";3543709
"Rincão";"2018";"10476";"5252";"5224";"100,54";"8614";"1862";"82,23";3543709
"Rincão";"2019";"10486";"5255";"5231";"100,46";"8634";"1852";"82,34";3543709
"Rincão";"2020";"10496";"5257";"5239";"100,34";"8655";"1841";"82,46";3543709
"Rinópolis";"2016";"9795";"4939";"4856";"101,71";"8833";"962";"90,18";3543808
"Rinópolis";"2017";"9776";"4924";"4852";"101,48";"8857";"919";"90,6";3543808
"Rinópolis";"2018";"9757";"4910";"4847";"101,3";"8877";"880";"90,98";3543808
"Rinópolis";"2019";"9738";"4895";"4843";"101,07";"8894";"844";"91,33";3543808
"Rinópolis";"2020";"9720";"4881";"4839";"100,87";"8910";"810";"91,67";3543808
"Rio Claro";"2016";"195490";"95104";"100386";"94,74";"191051";"4439";"97,73";3543907
"Rio Claro";"2017";"196904";"95783";"101121";"94,72";"192479";"4425";"97,75";3543907
"Rio Claro";"2018";"198330";"96468";"101862";"94,7";"193917";"4413";"97,77";3543907
"Rio Claro";"2019";"199765";"97157";"102608";"94,69";"195363";"4402";"97,8";3543907
"Rio Claro";"2020";"201212";"97853";"103359";"94,67";"196819";"4393";"97,82";3543907
"Rio das Pedras";"2016";"32594";"16441";"16153";"101,78";"31804";"790";"97,58";3544004
"Rio das Pedras";"2017";"33041";"16661";"16380";"101,72";"32267";"774";"97,66";3544004
"Rio das Pedras";"2018";"33493";"16883";"16610";"101,64";"32732";"761";"97,73";3544004
"Rio das Pedras";"2019";"33951";"17108";"16843";"101,57";"33201";"750";"97,79";3544004
"Rio das Pedras";"2020";"34416";"17336";"17080";"101,5";"33676";"740";"97,85";3544004
"Rio Grande da Serra";"2016";"47508";"23485";"24023";"97,76";"47508";"-";"100";3544103
"Rio Grande da Serra";"2017";"48076";"23755";"24321";"97,67";"48076";"-";"100";3544103
"Rio Grande da Serra";"2018";"48648";"24027";"24621";"97,59";"48648";"-";"100";3544103
"Rio Grande da Serra";"2019";"49229";"24303";"24926";"97,5";"49229";"-";"100";3544103
"Rio Grande da Serra";"2020";"49816";"24582";"25234";"97,42";"49816";"-";"100";3544103
"Riolândia";"2016";"11084";"6256";"4828";"129,58";"8769";"2315";"79,11";3544202
"Riolândia";"2017";"11170";"6296";"4874";"129,18";"8837";"2333";"79,11";3544202
"Riolândia";"2018";"11256";"6336";"4920";"128,78";"8905";"2351";"79,11";3544202
"Riolândia";"2019";"11342";"6376";"4966";"128,39";"8973";"2369";"79,11";3544202
"Riolândia";"2020";"11431";"6418";"5013";"128,03";"9043";"2388";"79,11";3544202
"Riversul";"2016";"5855";"2877";"2978";"96,61";"4360";"1495";"74,47";3543501
"Riversul";"2017";"5817";"2857";"2960";"96,52";"4347";"1470";"74,73";3543501
"Riversul";"2018";"5779";"2836";"2943";"96,36";"4333";"1446";"74,98";3543501
"Riversul";"2019";"5742";"2816";"2926";"96,24";"4320";"1422";"75,24";3543501
"Riversul";"2020";"5705";"2796";"2909";"96,12";"4307";"1398";"75,5";3543501
"Rosana";"2016";"18791";"9276";"9515";"97,49";"17594";"1197";"93,63";3544251
"Rosana";"2017";"18689";"9216";"9473";"97,29";"17675";"1014";"94,57";3544251
"Rosana";"2018";"18588";"9156";"9432";"97,07";"17719";"869";"95,32";3544251
"Rosana";"2019";"18487";"9097";"9390";"96,88";"17730";"757";"95,91";3544251
"Rosana";"2020";"18387";"9038";"9349";"96,67";"17719";"668";"96,37";3544251
"Roseira";"2016";"10240";"5158";"5082";"101,5";"9793";"447";"95,63";3544301
"Roseira";"2017";"10339";"5206";"5133";"101,42";"9898";"441";"95,73";3544301
"Roseira";"2018";"10439";"5254";"5185";"101,33";"10003";"436";"95,82";3544301
"Roseira";"2019";"10540";"5302";"5238";"101,22";"10109";"431";"95,91";3544301
"Roseira";"2020";"10642";"5351";"5291";"101,13";"10216";"426";"96";3544301
"Rubiácea";"2016";"2965";"1501";"1464";"102,53";"1751";"1214";"59,06";3544400
"Rubiácea";"2017";"2999";"1517";"1482";"102,36";"1780";"1219";"59,35";3544400
"Rubiácea";"2018";"3034";"1533";"1501";"102,13";"1810";"1224";"59,66";3544400
"Rubiácea";"2019";"3070";"1549";"1521";"101,84";"1840";"1230";"59,93";3544400
"Rubiácea";"2020";"3106";"1566";"1540";"101,69";"1871";"1235";"60,24";3544400
"Rubinéia";"2016";"2945";"1446";"1499";"96,46";"2530";"415";"85,91";3544509
"Rubinéia";"2017";"2956";"1450";"1506";"96,28";"2554";"402";"86,4";3544509
"Rubinéia";"2018";"2967";"1455";"1512";"96,23";"2577";"390";"86,86";3544509
"Rubinéia";"2019";"2978";"1459";"1519";"96,05";"2599";"379";"87,27";3544509
"Rubinéia";"2020";"2989";"1463";"1526";"95,87";"2621";"368";"87,69";3544509
"Sabino";"2016";"5377";"2683";"2694";"99,59";"4839";"538";"89,99";3544608
"Sabino";"2017";"5399";"2691";"2708";"99,37";"4877";"522";"90,33";3544608
"Sabino";"2018";"5422";"2700";"2722";"99,19";"4916";"506";"90,67";3544608
"Sabino";"2019";"5445";"2708";"2737";"98,94";"4954";"491";"90,98";3544608
"Sabino";"2020";"5468";"2717";"2751";"98,76";"4991";"477";"91,28";3544608
"Sagres";"2016";"2365";"1171";"1194";"98,07";"1922";"443";"81,27";3544707
"Sagres";"2017";"2365";"1170";"1195";"97,91";"1940";"425";"82,03";3544707
"Sagres";"2018";"2363";"1168";"1195";"97,74";"1956";"407";"82,78";3544707
"Sagres";"2019";"2363";"1167";"1196";"97,58";"1973";"390";"83,5";3544707
"Sagres";"2020";"2362";"1166";"1196";"97,49";"1989";"373";"84,21";3544707
"Sales";"2016";"5836";"2952";"2884";"102,36";"5389";"447";"92,34";3544806
"Sales";"2017";"5889";"2974";"2915";"102,02";"5452";"437";"92,58";3544806
"Sales";"2018";"5942";"2996";"2946";"101,7";"5512";"430";"92,76";3544806
"Sales";"2019";"5995";"3018";"2977";"101,38";"5571";"424";"92,93";3544806
"Sales";"2020";"6050";"3041";"3009";"101,06";"5631";"419";"93,07";3544806
"Sales Oliveira";"2016";"11169";"5524";"5645";"97,86";"10387";"782";"93";3544905
"Sales Oliveira";"2017";"11255";"5564";"5691";"97,77";"10504";"751";"93,33";3544905
"Sales Oliveira";"2018";"11342";"5605";"5737";"97,7";"10620";"722";"93,63";3544905
"Sales Oliveira";"2019";"11430";"5646";"5784";"97,61";"10736";"694";"93,93";3544905
"Sales Oliveira";"2020";"11518";"5687";"5831";"97,53";"10850";"668";"94,2";3544905
"Salesópolis";"2016";"16346";"8198";"8148";"100,61";"10672";"5674";"65,29";3545001
"Salesópolis";"2017";"16468";"8251";"8217";"100,41";"10796";"5672";"65,56";3545001
"Salesópolis";"2018";"16590";"8304";"8286";"100,22";"10920";"5670";"65,82";3545001
"Salesópolis";"2019";"16713";"8357";"8356";"100,01";"11045";"5668";"66,09";3545001
"Salesópolis";"2020";"16838";"8411";"8427";"99,81";"11173";"5665";"66,36";3545001
"Salmourão";"2016";"4991";"2551";"2440";"104,55";"4629";"362";"92,75";3545100
"Salmourão";"2017";"5022";"2564";"2458";"104,31";"4677";"345";"93,13";3545100
"Salmourão";"2018";"5053";"2578";"2475";"104,16";"4725";"328";"93,51";3545100
"Salmourão";"2019";"5085";"2592";"2493";"103,97";"4772";"313";"93,84";3545100
"Salmourão";"2020";"5117";"2606";"2511";"103,78";"4818";"299";"94,16";3545100
"Saltinho";"2016";"7584";"3763";"3821";"98,48";"6350";"1234";"83,73";3545159
"Saltinho";"2017";"7652";"3793";"3859";"98,29";"6410";"1242";"83,77";3545159
"Saltinho";"2018";"7721";"3824";"3897";"98,13";"6471";"1250";"83,81";3545159
"Saltinho";"2019";"7790";"3855";"3935";"97,97";"6532";"1258";"83,85";3545159
"Saltinho";"2020";"7860";"3886";"3974";"97,79";"6594";"1266";"83,89";3545159
"Salto";"2016";"111492";"55013";"56479";"97,4";"110708";"784";"99,3";3545209
"Salto";"2017";"112449";"55476";"56973";"97,37";"111658";"791";"99,3";3545209
"Salto";"2018";"113416";"55943";"57473";"97,34";"112618";"798";"99,3";3545209
"Salto";"2019";"114389";"56413";"57976";"97,3";"113585";"804";"99,3";3545209
"Salto";"2020";"115372";"56888";"58484";"97,27";"114561";"811";"99,3";3545209
"Salto de Pirapora";"2016";"42656";"21139";"21517";"98,24";"33523";"9133";"78,59";3545308
"Salto de Pirapora";"2017";"43043";"21323";"21720";"98,17";"33840";"9203";"78,62";3545308
"Salto de Pirapora";"2018";"43433";"21508";"21925";"98,1";"34161";"9272";"78,65";3545308
"Salto de Pirapora";"2019";"43826";"21695";"22131";"98,03";"34484";"9342";"78,68";3545308
"Salto de Pirapora";"2020";"44223";"21883";"22340";"97,95";"34810";"9413";"78,71";3545308
"Salto Grande";"2016";"8962";"4425";"4537";"97,53";"8199";"763";"91,49";3545407
"Salto Grande";"2017";"8996";"4440";"4556";"97,45";"8246";"750";"91,66";3545407
"Salto Grande";"2018";"9029";"4454";"4575";"97,36";"8291";"738";"91,83";3545407
"Salto Grande";"2019";"9062";"4469";"4593";"97,3";"8336";"726";"91,99";3545407
"Salto Grande";"2020";"9095";"4483";"4612";"97,2";"8380";"715";"92,14";3545407
"Sandovalina";"2016";"4009";"2032";"1977";"102,78";"3060";"949";"76,33";3545506
"Sandovalina";"2017";"4059";"2056";"2003";"102,65";"3138";"921";"77,31";3545506
"Sandovalina";"2018";"4108";"2080";"2028";"102,56";"3215";"893";"78,26";3545506
"Sandovalina";"2019";"4160";"2105";"2055";"102,43";"3293";"867";"79,16";3545506
"Sandovalina";"2020";"4211";"2130";"2081";"102,35";"3371";"840";"80,05";3545506
"Santa Adélia";"2016";"14683";"7338";"7345";"99,9";"13891";"792";"94,61";3545605
"Santa Adélia";"2017";"14735";"7364";"7371";"99,91";"13940";"795";"94,6";3545605
"Santa Adélia";"2018";"14787";"7390";"7397";"99,91";"13990";"797";"94,61";3545605
"Santa Adélia";"2019";"14840";"7416";"7424";"99,89";"14040";"800";"94,61";3545605
"Santa Adélia";"2020";"14892";"7442";"7450";"99,89";"14089";"803";"94,61";3545605
"Santa Albertina";"2016";"5698";"2871";"2827";"101,56";"5009";"689";"87,91";3545704
"Santa Albertina";"2017";"5691";"2864";"2827";"101,31";"5022";"669";"88,24";3545704
"Santa Albertina";"2018";"5685";"2858";"2827";"101,1";"5035";"650";"88,57";3545704
"Santa Albertina";"2019";"5678";"2851";"2827";"100,85";"5046";"632";"88,87";3545704
"Santa Albertina";"2020";"5672";"2845";"2827";"100,64";"5057";"615";"89,16";3545704
"Santa Bárbara d'Oeste";"2016";"185487";"91752";"93735";"97,88";"184031";"1456";"99,22";3545803
"Santa Bárbara d'Oeste";"2017";"186296";"92120";"94176";"97,82";"184834";"1462";"99,22";3545803
"Santa Bárbara d'Oeste";"2018";"187109";"92490";"94619";"97,75";"185640";"1469";"99,21";3545803
"Santa Bárbara d'Oeste";"2019";"187926";"92861";"95065";"97,68";"186451";"1475";"99,22";3545803
"Santa Bárbara d'Oeste";"2020";"188745";"93233";"95512";"97,61";"187263";"1482";"99,21";3545803
"Santa Branca";"2016";"14019";"6970";"7049";"98,88";"12366";"1653";"88,21";3546009
"Santa Branca";"2017";"14059";"6984";"7075";"98,71";"12401";"1658";"88,21";3546009
"Santa Branca";"2018";"14099";"6999";"7100";"98,58";"12436";"1663";"88,2";3546009
"Santa Branca";"2019";"14138";"7013";"7125";"98,43";"12471";"1667";"88,21";3546009
"Santa Branca";"2020";"14179";"7028";"7151";"98,28";"12507";"1672";"88,21";3546009
"Santa Clara d'Oeste";"2016";"2044";"1049";"995";"105,43";"1607";"437";"78,62";3546108
"Santa Clara d'Oeste";"2017";"2035";"1044";"991";"105,35";"1609";"426";"79,07";3546108
"Santa Clara d'Oeste";"2018";"2024";"1038";"986";"105,27";"1610";"414";"79,55";3546108
"Santa Clara d'Oeste";"2019";"2015";"1033";"982";"105,19";"1613";"402";"80,05";3546108
"Santa Clara d'Oeste";"2020";"2006";"1028";"978";"105,11";"1614";"392";"80,46";3546108
"Santa Cruz da Conceição";"2016";"4213";"2075";"2138";"97,05";"3130";"1083";"74,29";3546207
"Santa Cruz da Conceição";"2017";"4247";"2090";"2157";"96,89";"3198";"1049";"75,3";3546207
"Santa Cruz da Conceição";"2018";"4280";"2105";"2175";"96,78";"3265";"1015";"76,29";3546207
"Santa Cruz da Conceição";"2019";"4315";"2121";"2194";"96,67";"3332";"983";"77,22";3546207
"Santa Cruz da Conceição";"2020";"4349";"2136";"2213";"96,52";"3398";"951";"78,13";3546207
"Santa Cruz da Esperança";"2016";"2030";"1000";"1030";"97,09";"1388";"642";"68,37";3546256
"Santa Cruz da Esperança";"2017";"2041";"1005";"1036";"97,01";"1398";"643";"68,5";3546256
"Santa Cruz da Esperança";"2018";"2054";"1011";"1043";"96,93";"1409";"645";"68,6";3546256
"Santa Cruz da Esperança";"2019";"2065";"1016";"1049";"96,85";"1419";"646";"68,72";3546256
"Santa Cruz da Esperança";"2020";"2077";"1021";"1056";"96,69";"1429";"648";"68,8";3546256
"Santa Cruz das Palmeiras";"2016";"32262";"16347";"15915";"102,71";"31479";"783";"97,57";3546306
"Santa Cruz das Palmeiras";"2017";"32622";"16519";"16103";"102,58";"31856";"766";"97,65";3546306
"Santa Cruz das Palmeiras";"2018";"32987";"16694";"16293";"102,46";"32234";"753";"97,72";3546306
"Santa Cruz das Palmeiras";"2019";"33356";"16870";"16486";"102,33";"32615";"741";"97,78";3546306
"Santa Cruz das Palmeiras";"2020";"33729";"17048";"16681";"102,2";"32998";"731";"97,83";3546306
"Santa Cruz do Rio Pardo";"2016";"45235";"22113";"23122";"95,64";"42124";"3111";"93,12";3546405
"Santa Cruz do Rio Pardo";"2017";"45452";"22213";"23239";"95,59";"42420";"3032";"93,33";3546405
"Santa Cruz do Rio Pardo";"2018";"45671";"22314";"23357";"95,53";"42710";"2961";"93,52";3546405
"Santa Cruz do Rio Pardo";"2019";"45890";"22415";"23475";"95,48";"42995";"2895";"93,69";3546405
"Santa Cruz do Rio Pardo";"2020";"46110";"22516";"23594";"95,43";"43274";"2836";"93,85";3546405
"Santa Ernestina";"2016";"5538";"2836";"2702";"104,96";"5280";"258";"95,34";3546504
"Santa Ernestina";"2017";"5534";"2834";"2700";"104,96";"5291";"243";"95,61";3546504
"Santa Ernestina";"2018";"5532";"2833";"2699";"104,96";"5302";"230";"95,84";3546504
"Santa Ernestina";"2019";"5528";"2831";"2697";"104,97";"5309";"219";"96,04";3546504
"Santa Ernestina";"2020";"5525";"2829";"2696";"104,93";"5316";"209";"96,22";3546504
"Santa Fé do Sul";"2016";"30204";"14501";"15703";"92,35";"29015";"1189";"96,06";3546603
"Santa Fé do Sul";"2017";"30353";"14568";"15785";"92,29";"29158";"1195";"96,06";3546603
"Santa Fé do Sul";"2018";"30503";"14635";"15868";"92,23";"29302";"1201";"96,06";3546603
"Santa Fé do Sul";"2019";"30653";"14702";"15951";"92,17";"29446";"1207";"96,06";3546603
"Santa Fé do Sul";"2020";"30804";"14770";"16034";"92,12";"29591";"1213";"96,06";3546603
"Santa Gertrudes";"2016";"24376";"12309";"12067";"102,01";"24117";"259";"98,94";3546702
"Santa Gertrudes";"2017";"24818";"12526";"12292";"101,9";"24554";"264";"98,94";3546702
"Santa Gertrudes";"2018";"25266";"12745";"12521";"101,79";"24997";"269";"98,94";3546702
"Santa Gertrudes";"2019";"25723";"12969";"12754";"101,69";"25450";"273";"98,94";3546702
"Santa Gertrudes";"2020";"26189";"13197";"12992";"101,58";"25911";"278";"98,94";3546702
"Santa Isabel";"2016";"53310";"26555";"26755";"99,25";"42716";"10594";"80,13";3546801
"Santa Isabel";"2017";"53748";"26755";"26993";"99,12";"43210";"10538";"80,39";3546801
"Santa Isabel";"2018";"54191";"26957";"27234";"98,98";"43709";"10482";"80,66";3546801
"Santa Isabel";"2019";"54637";"27160";"27477";"98,85";"44211";"10426";"80,92";3546801
"Santa Isabel";"2020";"55086";"27364";"27722";"98,71";"44716";"10370";"81,17";3546801
"Santa Lúcia";"2016";"8444";"4206";"4238";"99,24";"8048";"396";"95,31";3546900
"Santa Lúcia";"2017";"8474";"4218";"4256";"99,11";"8090";"384";"95,47";3546900
"Santa Lúcia";"2018";"8503";"4230";"4273";"98,99";"8130";"373";"95,61";3546900
"Santa Lúcia";"2019";"8532";"4242";"4290";"98,88";"8169";"363";"95,75";3546900
"Santa Lúcia";"2020";"8562";"4254";"4308";"98,75";"8208";"354";"95,87";3546900
"Santa Maria da Serra";"2016";"5845";"2945";"2900";"101,55";"5255";"590";"89,91";3547007
"Santa Maria da Serra";"2017";"5918";"2979";"2939";"101,36";"5336";"582";"90,17";3547007
"Santa Maria da Serra";"2018";"5992";"3013";"2979";"101,14";"5418";"574";"90,42";3547007
"Santa Maria da Serra";"2019";"6066";"3047";"3019";"100,93";"5500";"566";"90,67";3547007
"Santa Maria da Serra";"2020";"6141";"3082";"3059";"100,75";"5583";"558";"90,91";3547007
"Santa Mercedes";"2016";"2815";"1401";"1414";"99,08";"2530";"285";"89,88";3547106
"Santa Mercedes";"2017";"2815";"1399";"1416";"98,8";"2542";"273";"90,3";3547106
"Santa Mercedes";"2018";"2814";"1397";"1417";"98,59";"2552";"262";"90,69";3547106
"Santa Mercedes";"2019";"2814";"1395";"1419";"98,31";"2563";"251";"91,08";3547106
"Santa Mercedes";"2020";"2813";"1393";"1420";"98,1";"2572";"241";"91,43";3547106
"Santa Rita d'Oeste";"2016";"2461";"1219";"1242";"98,15";"1860";"601";"75,58";3547403
"Santa Rita d'Oeste";"2017";"2446";"1211";"1235";"98,06";"1869";"577";"76,41";3547403
"Santa Rita d'Oeste";"2018";"2432";"1203";"1229";"97,88";"1879";"553";"77,26";3547403
"Santa Rita d'Oeste";"2019";"2418";"1196";"1222";"97,87";"1887";"531";"78,04";3547403
"Santa Rita d'Oeste";"2020";"2404";"1188";"1216";"97,7";"1895";"509";"78,83";3547403
"Santa Rita do Passa Quatro";"2016";"26430";"12784";"13646";"93,68";"24073";"2357";"91,08";3547502
"Santa Rita do Passa Quatro";"2017";"26419";"12777";"13642";"93,66";"24124";"2295";"91,31";3547502
"Santa Rita do Passa Quatro";"2018";"26408";"12771";"13637";"93,65";"24173";"2235";"91,54";3547502
"Santa Rita do Passa Quatro";"2019";"26397";"12764";"13633";"93,63";"24220";"2177";"91,75";3547502
"Santa Rita do Passa Quatro";"2020";"26385";"12757";"13628";"93,61";"24263";"2122";"91,96";3547502
"Santa Rosa de Viterbo";"2016";"24930";"12274";"12656";"96,98";"23904";"1026";"95,88";3547601
"Santa Rosa de Viterbo";"2017";"25096";"12352";"12744";"96,92";"24085";"1011";"95,97";3547601
"Santa Rosa de Viterbo";"2018";"25264";"12431";"12833";"96,87";"24268";"996";"96,06";3547601
"Santa Rosa de Viterbo";"2019";"25434";"12511";"12923";"96,81";"24452";"982";"96,14";3547601
"Santa Rosa de Viterbo";"2020";"25604";"12591";"13013";"96,76";"24636";"968";"96,22";3547601
"Santa Salete";"2016";"1446";"736";"710";"103,66";"956";"490";"66,11";3547650
"Santa Salete";"2017";"1444";"734";"710";"103,38";"975";"469";"67,52";3547650
"Santa Salete";"2018";"1443";"732";"711";"102,95";"995";"448";"68,95";3547650
"Santa Salete";"2019";"1441";"730";"711";"102,67";"1013";"428";"70,3";3547650
"Santa Salete";"2020";"1440";"728";"712";"102,25";"1031";"409";"71,6";3547650
"Santana da Ponte Pensa";"2016";"1555";"788";"767";"102,74";"1109";"446";"71,32";3547205
"Santana da Ponte Pensa";"2017";"1543";"781";"762";"102,49";"1111";"432";"72";3547205
"Santana da Ponte Pensa";"2018";"1532";"774";"758";"102,11";"1113";"419";"72,65";3547205
"Santana da Ponte Pensa";"2019";"1520";"767";"753";"101,86";"1115";"405";"73,36";3547205
"Santana da Ponte Pensa";"2020";"1509";"760";"749";"101,47";"1116";"393";"73,96";3547205
"Santana de Parnaíba";"2016";"126747";"62468";"64279";"97,18";"126747";"-";"100";3547304
"Santana de Parnaíba";"2017";"129502";"63821";"65681";"97,17";"129502";"-";"100";3547304
"Santana de Parnaíba";"2018";"132317";"65203";"67114";"97,15";"132317";"-";"100";3547304
"Santana de Parnaíba";"2019";"135194";"66615";"68579";"97,14";"135194";"-";"100";3547304
"Santana de Parnaíba";"2020";"138132";"68057";"70075";"97,12";"138132";"-";"100";3547304
"Santo Anastácio";"2016";"20231";"9839";"10392";"94,68";"18992";"1239";"93,88";3547700
"Santo Anastácio";"2017";"20205";"9825";"10380";"94,65";"18989";"1216";"93,98";3547700
"Santo Anastácio";"2018";"20179";"9810";"10369";"94,61";"18986";"1193";"94,09";3547700
"Santo Anastácio";"2019";"20153";"9796";"10357";"94,58";"18981";"1172";"94,18";3547700
"Santo Anastácio";"2020";"20127";"9781";"10346";"94,54";"18977";"1150";"94,29";3547700
"Santo André";"2016";"687250";"329986";"357264";"92,36";"687250";"-";"100";3547809
"Santo André";"2017";"688899";"330816";"358083";"92,39";"688899";"-";"100";3547809
"Santo André";"2018";"690551";"331648";"358903";"92,41";"690551";"-";"100";3547809
"Santo André";"2019";"692207";"332482";"359725";"92,43";"692207";"-";"100";3547809
"Santo André";"2020";"693867";"333318";"360549";"92,45";"693867";"-";"100";3547809
"Santo Antônio da Alegria";"2016";"6508";"3341";"3167";"105,49";"4870";"1638";"74,83";3547908
"Santo Antônio da Alegria";"2017";"6541";"3354";"3187";"105,24";"4903";"1638";"74,96";3547908
"Santo Antônio da Alegria";"2018";"6572";"3366";"3206";"104,99";"4934";"1638";"75,08";3547908
"Santo Antônio da Alegria";"2019";"6605";"3379";"3226";"104,74";"4967";"1638";"75,2";3547908
"Santo Antônio da Alegria";"2020";"6637";"3391";"3246";"104,47";"4999";"1638";"75,32";3547908
"Santo Antônio de Posse";"2016";"22006";"11044";"10962";"100,75";"20752";"1254";"94,3";3548005
"Santo Antônio de Posse";"2017";"22214";"11142";"11072";"100,63";"21030";"1184";"94,67";3548005
"Santo Antônio de Posse";"2018";"22424";"11241";"11183";"100,52";"21305";"1119";"95,01";3548005
"Santo Antônio de Posse";"2019";"22635";"11340";"11295";"100,4";"21574";"1061";"95,31";3548005
"Santo Antônio de Posse";"2020";"22849";"11441";"11408";"100,29";"21842";"1007";"95,59";3548005
"Santo Antônio do Aracanguá";"2016";"8019";"4057";"3962";"102,4";"6733";"1286";"83,96";3548054
"Santo Antônio do Aracanguá";"2017";"8077";"4083";"3994";"102,23";"6846";"1231";"84,76";3548054
"Santo Antônio do Aracanguá";"2018";"8135";"4109";"4026";"102,06";"6958";"1177";"85,53";3548054
"Santo Antônio do Aracanguá";"2019";"8193";"4135";"4058";"101,9";"7067";"1126";"86,26";3548054
"Santo Antônio do Aracanguá";"2020";"8252";"4161";"4091";"101,71";"7174";"1078";"86,94";3548054
"Santo Antônio do Jardim";"2016";"5858";"2991";"2867";"104,33";"3692";"2166";"63,02";3548104
"Santo Antônio do Jardim";"2017";"5850";"2986";"2864";"104,26";"3721";"2129";"63,61";3548104
"Santo Antônio do Jardim";"2018";"5842";"2980";"2862";"104,12";"3750";"2092";"64,19";3548104
"Santo Antônio do Jardim";"2019";"5834";"2975";"2859";"104,06";"3778";"2056";"64,76";3548104
"Santo Antônio do Jardim";"2020";"5826";"2970";"2856";"103,99";"3806";"2020";"65,33";3548104
"Santo Antônio do Pinhal";"2016";"6565";"3286";"3279";"100,21";"4326";"2239";"65,89";3548203
"Santo Antônio do Pinhal";"2017";"6580";"3290";"3290";"100";"4403";"2177";"66,91";3548203
"Santo Antônio do Pinhal";"2018";"6596";"3295";"3301";"99,82";"4480";"2116";"67,92";3548203
"Santo Antônio do Pinhal";"2019";"6612";"3299";"3313";"99,58";"4556";"2056";"68,91";3548203
"Santo Antônio do Pinhal";"2020";"6628";"3304";"3324";"99,4";"4631";"1997";"69,87";3548203
"Santo Expedito";"2016";"2907";"1451";"1456";"99,66";"2668";"239";"91,78";3548302
"Santo Expedito";"2017";"2923";"1458";"1465";"99,52";"2695";"228";"92,2";3548302
"Santo Expedito";"2018";"2939";"1466";"1473";"99,52";"2722";"217";"92,62";3548302
"Santo Expedito";"2019";"2956";"1474";"1482";"99,46";"2749";"207";"93";3548302
"Santo Expedito";"2020";"2972";"1482";"1490";"99,46";"2774";"198";"93,34";3548302
"Santópolis do Aguapeí";"2016";"4519";"2280";"2239";"101,83";"4397";"122";"97,3";3548401
"Santópolis do Aguapeí";"2017";"4555";"2297";"2258";"101,73";"4436";"119";"97,39";3548401
"Santópolis do Aguapeí";"2018";"4593";"2315";"2278";"101,62";"4476";"117";"97,45";3548401
"Santópolis do Aguapeí";"2019";"4630";"2333";"2297";"101,57";"4515";"115";"97,52";3548401
"Santópolis do Aguapeí";"2020";"4668";"2351";"2317";"101,47";"4555";"113";"97,58";3548401
"Santos";"2016";"424599";"195263";"229336";"85,14";"424281";"318";"99,93";3548500
"Santos";"2017";"425621";"195905";"229716";"85,28";"425302";"319";"99,93";3548500
"Santos";"2018";"426646";"196549";"230097";"85,42";"426327";"319";"99,93";3548500
"Santos";"2019";"427673";"197195";"230478";"85,56";"427353";"320";"99,93";3548500
"Santos";"2020";"428703";"197843";"230860";"85,7";"428382";"321";"99,93";3548500
"São Bento do Sapucaí";"2016";"10491";"5255";"5236";"100,36";"5270";"5221";"50,23";3548609
"São Bento do Sapucaí";"2017";"10501";"5256";"5245";"100,21";"5311";"5190";"50,58";3548609
"São Bento do Sapucaí";"2018";"10510";"5256";"5254";"100,04";"5352";"5158";"50,92";3548609
"São Bento do Sapucaí";"2019";"10520";"5257";"5263";"99,89";"5394";"5126";"51,27";3548609
"São Bento do Sapucaí";"2020";"10530";"5258";"5272";"99,73";"5435";"5095";"51,61";3548609
"São Bernardo do Campo";"2016";"795541";"384439";"411102";"93,51";"782548";"12993";"98,37";3548708
"São Bernardo do Campo";"2017";"799645";"386451";"413194";"93,53";"786636";"13009";"98,37";3548708
"São Bernardo do Campo";"2018";"803771";"388474";"415297";"93,54";"790745";"13026";"98,38";3548708
"São Bernardo do Campo";"2019";"807917";"390507";"417410";"93,55";"794875";"13042";"98,39";3548708
"São Bernardo do Campo";"2020";"812086";"392552";"419534";"93,57";"799027";"13059";"98,39";3548708
"São Caetano do Sul";"2016";"150732";"69847";"80885";"86,35";"150732";"-";"100";3548807
"São Caetano do Sul";"2017";"150860";"69956";"80904";"86,47";"150860";"-";"100";3548807
"São Caetano do Sul";"2018";"150988";"70066";"80922";"86,58";"150988";"-";"100";3548807
"São Caetano do Sul";"2019";"151116";"70175";"80941";"86,7";"151116";"-";"100";3548807
"São Caetano do Sul";"2020";"151244";"70285";"80959";"86,82";"151244";"-";"100";3548807
"São Carlos";"2016";"235096";"115233";"119863";"96,14";"225681";"9415";"96";3548906
"São Carlos";"2017";"236958";"116123";"120835";"96,1";"227468";"9490";"96";3548906
"São Carlos";"2018";"238834";"117020";"121814";"96,06";"229269";"9565";"96";3548906
"São Carlos";"2019";"240726";"117925";"122801";"96,03";"231085";"9641";"96";3548906
"São Carlos";"2020";"242632";"118836";"123796";"95,99";"232915";"9717";"96";3548906
"São Francisco";"2016";"2723";"1356";"1367";"99,2";"2191";"532";"80,46";3549003
"São Francisco";"2017";"2712";"1349";"1363";"98,97";"2194";"518";"80,9";3549003
"São Francisco";"2018";"2700";"1342";"1358";"98,82";"2195";"505";"81,3";3549003
"São Francisco";"2019";"2689";"1335";"1354";"98,6";"2198";"491";"81,74";3549003
"São Francisco";"2020";"2677";"1328";"1349";"98,44";"2198";"479";"82,11";3549003
"São João da Boa Vista";"2016";"86021";"41679";"44342";"93,99";"83414";"2607";"96,97";3549102
"São João da Boa Vista";"2017";"86349";"41832";"44517";"93,97";"83831";"2518";"97,08";3549102
"São João da Boa Vista";"2018";"86679";"41986";"44693";"93,94";"84243";"2436";"97,19";3549102
"São João da Boa Vista";"2019";"87008";"42139";"44869";"93,92";"84646";"2362";"97,29";3549102
"São João da Boa Vista";"2020";"87340";"42294";"45046";"93,89";"85046";"2294";"97,37";3549102
"São João das Duas Pontes";"2016";"2508";"1244";"1264";"98,42";"1927";"581";"76,83";3549201
"São João das Duas Pontes";"2017";"2501";"1238";"1263";"98,02";"1923";"578";"76,89";3549201
"São João das Duas Pontes";"2018";"2492";"1231";"1261";"97,62";"1917";"575";"76,93";3549201
"São João das Duas Pontes";"2019";"2485";"1225";"1260";"97,22";"1914";"571";"77,02";3549201
"São João das Duas Pontes";"2020";"2476";"1218";"1258";"96,82";"1908";"568";"77,06";3549201
"São João de Iracema";"2016";"1826";"917";"909";"100,88";"1583";"243";"86,69";3549250
"São João de Iracema";"2017";"1832";"919";"913";"100,66";"1601";"231";"87,39";3549250
"São João de Iracema";"2018";"1838";"921";"917";"100,44";"1618";"220";"88,03";3549250
"São João de Iracema";"2019";"1844";"923";"921";"100,22";"1635";"209";"88,67";3549250
"São João de Iracema";"2020";"1850";"925";"925";"100";"1652";"198";"89,3";3549250
"São João do Pau d'Alho";"2016";"2027";"1005";"1022";"98,34";"1713";"314";"84,51";3549300
"São João do Pau d'Alho";"2017";"2016";"997";"1019";"97,84";"1714";"302";"85,02";3549300
"São João do Pau d'Alho";"2018";"2005";"990";"1015";"97,54";"1714";"291";"85,49";3549300
"São João do Pau d'Alho";"2019";"1995";"983";"1012";"97,13";"1715";"280";"85,96";3549300
"São João do Pau d'Alho";"2020";"1985";"976";"1009";"96,73";"1716";"269";"86,45";3549300
"São Joaquim da Barra";"2016";"48874";"23913";"24961";"95,8";"48008";"866";"98,23";3549409
"São Joaquim da Barra";"2017";"49220";"24078";"25142";"95,77";"48349";"871";"98,23";3549409
"São Joaquim da Barra";"2018";"49569";"24244";"25325";"95,73";"48692";"877";"98,23";3549409
"São Joaquim da Barra";"2019";"49921";"24412";"25509";"95,7";"49039";"882";"98,23";3549409
"São Joaquim da Barra";"2020";"50274";"24580";"25694";"95,66";"49386";"888";"98,23";3549409
"São José da Bela Vista";"2016";"8589";"4384";"4205";"104,26";"7766";"823";"90,42";3549508
"São José da Bela Vista";"2017";"8624";"4398";"4226";"104,07";"7815";"809";"90,62";3549508
"São José da Bela Vista";"2018";"8658";"4412";"4246";"103,91";"7864";"794";"90,83";3549508
"São José da Bela Vista";"2019";"8692";"4426";"4266";"103,75";"7912";"780";"91,03";3549508
"São José da Bela Vista";"2020";"8727";"4440";"4287";"103,57";"7961";"766";"91,22";3549508
"São José do Barreiro";"2016";"4069";"2031";"2038";"99,66";"3086";"983";"75,84";3549607
"São José do Barreiro";"2017";"4069";"2030";"2039";"99,56";"3120";"949";"76,68";3549607
"São José do Barreiro";"2018";"4069";"2028";"2041";"99,36";"3153";"916";"77,49";3549607
"São José do Barreiro";"2019";"4069";"2027";"2042";"99,27";"3185";"884";"78,27";3549607
"São José do Barreiro";"2020";"4070";"2026";"2044";"99,12";"3217";"853";"79,04";3549607
"São José do Rio Pardo";"2016";"52716";"25887";"26829";"96,49";"47922";"4794";"90,91";3549706
"São José do Rio Pardo";"2017";"52839";"25939";"26900";"96,43";"48212";"4627";"91,24";3549706
"São José do Rio Pardo";"2018";"52960";"25990";"26970";"96,37";"48493";"4467";"91,57";3549706
"São José do Rio Pardo";"2019";"53083";"26042";"27041";"96,31";"48770";"4313";"91,87";3549706
"São José do Rio Pardo";"2020";"53206";"26094";"27112";"96,25";"49041";"4165";"92,17";3549706
"São José do Rio Preto";"2016";"433779";"208914";"224865";"92,91";"407463";"26316";"93,93";3549805
"São José do Rio Preto";"2017";"437273";"210613";"226660";"92,92";"410745";"26528";"93,93";3549805
"São José do Rio Preto";"2018";"440796";"212327";"228469";"92,93";"414054";"26742";"93,93";3549805
"São José do Rio Preto";"2019";"444346";"214054";"230292";"92,95";"417389";"26957";"93,93";3549805
"São José do Rio Preto";"2020";"447924";"215795";"232129";"92,96";"420750";"27174";"93,93";3549805
"São José dos Campos";"2016";"680008";"332732";"347276";"95,81";"666174";"13834";"97,97";3549904
"São José dos Campos";"2017";"687544";"336338";"351206";"95,77";"673557";"13987";"97,97";3549904
"São José dos Campos";"2018";"695163";"339983";"355180";"95,72";"681021";"14142";"97,97";3549904
"São José dos Campos";"2019";"702866";"343667";"359199";"95,68";"688567";"14299";"97,97";3549904
"São José dos Campos";"2020";"710654";"347392";"363262";"95,63";"696197";"14457";"97,97";3549904
"São Lourenço da Serra";"2016";"14920";"7519";"7401";"101,59";"13773";"1147";"92,31";3549953
"São Lourenço da Serra";"2017";"15082";"7593";"7489";"101,39";"13952";"1130";"92,51";3549953
"São Lourenço da Serra";"2018";"15246";"7668";"7578";"101,19";"14133";"1113";"92,7";3549953
"São Lourenço da Serra";"2019";"15412";"7744";"7668";"100,99";"14315";"1097";"92,88";3549953
"São Lourenço da Serra";"2020";"15579";"7820";"7759";"100,79";"14499";"1080";"93,07";3549953
"São Luiz do Paraitinga";"2016";"10493";"5334";"5159";"103,39";"6270";"4223";"59,75";3550001
"São Luiz do Paraitinga";"2017";"10511";"5338";"5173";"103,19";"6286";"4225";"59,8";3550001
"São Luiz do Paraitinga";"2018";"10531";"5343";"5188";"102,99";"6303";"4228";"59,85";3550001
"São Luiz do Paraitinga";"2019";"10549";"5347";"5202";"102,79";"6319";"4230";"59,9";3550001
"São Luiz do Paraitinga";"2020";"10569";"5352";"5217";"102,59";"6337";"4232";"59,96";3550001
"São Manuel";"2016";"39080";"19092";"19988";"95,52";"38453";"627";"98,4";3550100
"São Manuel";"2017";"39202";"19147";"20055";"95,47";"38604";"598";"98,47";3550100
"São Manuel";"2018";"39326";"19203";"20123";"95,43";"38753";"573";"98,54";3550100
"São Manuel";"2019";"39450";"19258";"20192";"95,37";"38899";"551";"98,6";3550100
"São Manuel";"2020";"39574";"19314";"20260";"95,33";"39042";"532";"98,66";3550100
"São Miguel Arcanjo";"2016";"31745";"16081";"15664";"102,66";"23380";"8365";"73,65";3550209
"São Miguel Arcanjo";"2017";"31809";"16104";"15705";"102,54";"23688";"8121";"74,47";3550209
"São Miguel Arcanjo";"2018";"31872";"16126";"15746";"102,41";"23991";"7881";"75,27";3550209
"São Miguel Arcanjo";"2019";"31936";"16149";"15787";"102,29";"24289";"7647";"76,06";3550209
"São Miguel Arcanjo";"2020";"32000";"16172";"15828";"102,17";"24583";"7417";"76,82";3550209
"São Paulo";"2016";"11638802";"5530003";"6108799";"90,53";"11534180";"104622";"99,1";3550308
"São Paulo";"2017";"11696088";"5560118";"6135970";"90,62";"11590951";"105137";"99,1";3550308
"São Paulo";"2018";"11753659";"5590397";"6163262";"90,71";"11648004";"105655";"99,1";3550308
"São Paulo";"2019";"11811516";"5620841";"6190675";"90,8";"11705341";"106175";"99,1";3550308
"São Paulo";"2020";"11869660";"5651451";"6218209";"90,89";"11762962";"106698";"99,1";3550308
"São Pedro";"2016";"33249";"16145";"17104";"94,39";"28561";"4688";"85,9";3550407
"São Pedro";"2017";"33486";"16255";"17231";"94,34";"28861";"4625";"86,19";3550407
"São Pedro";"2018";"33725";"16366";"17359";"94,28";"29163";"4562";"86,47";3550407
"São Pedro";"2019";"33966";"16477";"17489";"94,21";"29466";"4500";"86,75";3550407
"São Pedro";"2020";"34208";"16589";"17619";"94,15";"29769";"4439";"87,02";3550407
"São Pedro do Turvo";"2016";"7289";"3702";"3587";"103,21";"5504";"1785";"75,51";3550506
"São Pedro do Turvo";"2017";"7308";"3710";"3598";"103,11";"5563";"1745";"76,12";3550506
"São Pedro do Turvo";"2018";"7329";"3719";"3610";"103,02";"5623";"1706";"76,72";3550506
"São Pedro do Turvo";"2019";"7348";"3727";"3621";"102,93";"5681";"1667";"77,31";3550506
"São Pedro do Turvo";"2020";"7369";"3736";"3633";"102,84";"5739";"1630";"77,88";3550506
"São Roque";"2016";"84281";"41299";"42982";"96,08";"80172";"4109";"95,12";3550605
"São Roque";"2017";"85059";"41658";"43401";"95,98";"81313";"3746";"95,6";3550605
"São Roque";"2018";"85844";"42020";"43824";"95,88";"82421";"3423";"96,01";3550605
"São Roque";"2019";"86636";"42385";"44251";"95,78";"83498";"3138";"96,38";3550605
"São Roque";"2020";"87435";"42753";"44682";"95,68";"84550";"2885";"96,7";3550605
"São Sebastião";"2016";"82079";"40766";"41313";"98,68";"81154";"925";"98,87";3550704
"São Sebastião";"2017";"83314";"41351";"41963";"98,54";"82375";"939";"98,87";3550704
"São Sebastião";"2018";"84569";"41946";"42623";"98,41";"83616";"953";"98,87";3550704
"São Sebastião";"2019";"85843";"42549";"43294";"98,28";"84876";"967";"98,87";3550704
"São Sebastião";"2020";"87135";"43160";"43975";"98,15";"86153";"982";"98,87";3550704
"São Sebastião da Grama";"2016";"11968";"6097";"5871";"103,85";"8268";"3700";"69,08";3550803
"São Sebastião da Grama";"2017";"11960";"6092";"5868";"103,82";"8325";"3635";"69,61";3550803
"São Sebastião da Grama";"2018";"11952";"6086";"5866";"103,75";"8380";"3572";"70,11";3550803
"São Sebastião da Grama";"2019";"11944";"6081";"5863";"103,72";"8435";"3509";"70,62";3550803
"São Sebastião da Grama";"2020";"11936";"6076";"5860";"103,69";"8489";"3447";"71,12";3550803
"São Simão";"2016";"14638";"7199";"7439";"96,77";"13396";"1242";"91,52";3550902
"São Simão";"2017";"14689";"7223";"7466";"96,75";"13474";"1215";"91,73";3550902
"São Simão";"2018";"14742";"7248";"7494";"96,72";"13553";"1189";"91,93";3550902
"São Simão";"2019";"14794";"7273";"7521";"96,7";"13631";"1163";"92,14";3550902
"São Simão";"2020";"14847";"7298";"7549";"96,68";"13710";"1137";"92,34";3550902
"São Vicente";"2016";"347733";"167197";"180536";"92,61";"347076";"657";"99,81";3551009
"São Vicente";"2017";"350254";"168442";"181812";"92,65";"349592";"662";"99,81";3551009
"São Vicente";"2018";"352794";"169697";"183097";"92,68";"352128";"666";"99,81";3551009
"São Vicente";"2019";"355352";"170961";"184391";"92,72";"354681";"671";"99,81";3551009
"São Vicente";"2020";"357929";"172235";"185694";"92,75";"357253";"676";"99,81";3551009
"Sarapuí";"2016";"9675";"4879";"4796";"101,73";"7535";"2140";"77,88";3551108
"Sarapuí";"2017";"9782";"4927";"4855";"101,48";"7683";"2099";"78,54";3551108
"Sarapuí";"2018";"9890";"4975";"4915";"101,22";"7831";"2059";"79,18";3551108
"Sarapuí";"2019";"9999";"5023";"4976";"100,94";"7980";"2019";"79,81";3551108
"Sarapuí";"2020";"10110";"5072";"5038";"100,67";"8130";"1980";"80,42";3551108
"Sarutaiá";"2016";"3633";"1826";"1807";"101,05";"3075";"558";"84,64";3551207
"Sarutaiá";"2017";"3636";"1827";"1809";"101";"3094";"542";"85,09";3551207
"Sarutaiá";"2018";"3639";"1829";"1810";"101,05";"3112";"527";"85,52";3551207
"Sarutaiá";"2019";"3642";"1830";"1812";"100,99";"3131";"511";"85,97";3551207
"Sarutaiá";"2020";"3646";"1832";"1814";"100,99";"3149";"497";"86,37";3551207
"Sebastianópolis do Sul";"2016";"3207";"1607";"1600";"100,44";"2652";"555";"82,69";3551306
"Sebastianópolis do Sul";"2017";"3229";"1617";"1612";"100,31";"2693";"536";"83,4";3551306
"Sebastianópolis do Sul";"2018";"3250";"1627";"1623";"100,25";"2733";"517";"84,09";3551306
"Sebastianópolis do Sul";"2019";"3271";"1637";"1634";"100,18";"2771";"500";"84,71";3551306
"Sebastianópolis do Sul";"2020";"3293";"1647";"1646";"100,06";"2810";"483";"85,33";3551306
"Serra Azul";"2016";"11863";"7142";"4721";"151,28";"8449";"3414";"71,22";3551405
"Serra Azul";"2017";"11966";"7190";"4776";"150,54";"8523";"3443";"71,23";3551405
"Serra Azul";"2018";"12070";"7238";"4832";"149,79";"8597";"3473";"71,23";3551405
"Serra Azul";"2019";"12175";"7287";"4888";"149,08";"8672";"3503";"71,23";3551405
"Serra Azul";"2020";"12282";"7337";"4945";"148,37";"8748";"3534";"71,23";3551405
"Serra Negra";"2016";"27072";"13129";"13943";"94,16";"23541";"3531";"86,96";3551603
"Serra Negra";"2017";"27164";"13166";"13998";"94,06";"23630";"3534";"86,99";3551603
"Serra Negra";"2018";"27255";"13202";"14053";"93,94";"23718";"3537";"87,02";3551603
"Serra Negra";"2019";"27347";"13239";"14108";"93,84";"23807";"3540";"87,06";3551603
"Serra Negra";"2020";"27440";"13276";"14164";"93,73";"23897";"3543";"87,09";3551603
"Serrana";"2016";"42296";"21137";"21159";"99,9";"41997";"299";"99,29";3551504
"Serrana";"2017";"42820";"21389";"21431";"99,8";"42535";"285";"99,33";3551504
"Serrana";"2018";"43352";"21645";"21707";"99,71";"43079";"273";"99,37";3551504
"Serrana";"2019";"43890";"21904";"21986";"99,63";"43629";"261";"99,41";3551504
"Serrana";"2020";"44434";"22166";"22268";"99,54";"44183";"251";"99,44";3551504
"Sertãozinho";"2016";"117916";"58488";"59428";"98,42";"117160";"756";"99,36";3551702
"Sertãozinho";"2017";"119010";"59010";"60000";"98,35";"118307";"703";"99,41";3551702
"Sertãozinho";"2018";"120116";"59538";"60578";"98,28";"119460";"656";"99,45";3551702
"Sertãozinho";"2019";"121229";"60069";"61160";"98,22";"120612";"617";"99,49";3551702
"Sertãozinho";"2020";"122355";"60606";"61749";"98,15";"121772";"583";"99,52";3551702
"Sete Barras";"2016";"12680";"6445";"6235";"103,37";"8430";"4250";"66,48";3551801
"Sete Barras";"2017";"12666";"6427";"6239";"103,01";"8624";"4042";"68,09";3551801
"Sete Barras";"2018";"12654";"6410";"6244";"102,66";"8808";"3846";"69,61";3551801
"Sete Barras";"2019";"12641";"6393";"6248";"102,32";"8981";"3660";"71,05";3551801
"Sete Barras";"2020";"12628";"6376";"6252";"101,98";"9143";"3485";"72,4";3551801
"Severínia";"2016";"16492";"8507";"7985";"106,54";"15884";"608";"96,31";3551900
"Severínia";"2017";"16649";"8580";"8069";"106,33";"16051";"598";"96,41";3551900
"Severínia";"2018";"16806";"8653";"8153";"106,13";"16216";"590";"96,49";3551900
"Severínia";"2019";"16965";"8727";"8238";"105,94";"16381";"584";"96,56";3551900
"Severínia";"2020";"17126";"8802";"8324";"105,74";"16546";"580";"96,61";3551900
"Silveiras";"2016";"6039";"3042";"2997";"101,5";"3151";"2888";"52,18";3552007
"Silveiras";"2017";"6080";"3060";"3020";"101,32";"3198";"2882";"52,6";3552007
"Silveiras";"2018";"6121";"3078";"3043";"101,15";"3245";"2876";"53,01";3552007
"Silveiras";"2019";"6162";"3096";"3066";"100,98";"3292";"2870";"53,42";3552007
"Silveiras";"2020";"6204";"3114";"3090";"100,78";"3339";"2865";"53,82";3552007
"Socorro";"2016";"38036";"18832";"19204";"98,06";"26693";"11343";"70,18";3552106
"Socorro";"2017";"38221";"18918";"19303";"98,01";"26959";"11262";"70,53";3552106
"Socorro";"2018";"38407";"19004";"19403";"97,94";"27225";"11182";"70,89";3552106
"Socorro";"2019";"38595";"19091";"19504";"97,88";"27494";"11101";"71,24";3552106
"Socorro";"2020";"38783";"19178";"19605";"97,82";"27762";"11021";"71,58";3552106
"Sorocaba";"2016";"630550";"308398";"322152";"95,73";"624133";"6417";"98,98";3552205
"Sorocaba";"2017";"637436";"311757";"325679";"95,73";"630949";"6487";"98,98";3552205
"Sorocaba";"2018";"644397";"315153";"329244";"95,72";"637839";"6558";"98,98";3552205
"Sorocaba";"2019";"651434";"318586";"332848";"95,72";"644804";"6630";"98,98";3552205
"Sorocaba";"2020";"658547";"322056";"336491";"95,71";"651845";"6702";"98,98";3552205
"Sud Mennucci";"2016";"7615";"3819";"3796";"100,61";"6553";"1062";"86,05";3552304
"Sud Mennucci";"2017";"7639";"3829";"3810";"100,5";"6576";"1063";"86,08";3552304
"Sud Mennucci";"2018";"7664";"3840";"3824";"100,42";"6599";"1065";"86,1";3552304
"Sud Mennucci";"2019";"7688";"3850";"3838";"100,31";"6621";"1067";"86,12";3552304
"Sud Mennucci";"2020";"7713";"3861";"3852";"100,23";"6644";"1069";"86,14";3552304
"Sumaré";"2016";"267313";"132434";"134879";"98,19";"264166";"3147";"98,82";3552403
"Sumaré";"2017";"271202";"134304";"136898";"98,11";"268009";"3193";"98,82";3552403
"Sumaré";"2018";"275147";"136200";"138947";"98,02";"271908";"3239";"98,82";3552403
"Sumaré";"2019";"279151";"138124";"141027";"97,94";"275865";"3286";"98,82";3552403
"Sumaré";"2020";"283212";"140074";"143138";"97,86";"279878";"3334";"98,82";3552403
"Suzanápolis";"2016";"3738";"1912";"1826";"104,71";"2495";"1243";"66,75";3552551
"Suzanápolis";"2017";"3790";"1936";"1854";"104,42";"2530";"1260";"66,75";3552551
"Suzanápolis";"2018";"3842";"1960";"1882";"104,14";"2564";"1278";"66,74";3552551
"Suzanápolis";"2019";"3894";"1984";"1910";"103,87";"2599";"1295";"66,74";3552551
"Suzanápolis";"2020";"3947";"2008";"1939";"103,56";"2634";"1313";"66,73";3552551
"Suzano";"2016";"279626";"136961";"142665";"96";"269782";"9844";"96,48";3552502
"Suzano";"2017";"282428";"138308";"144120";"95,97";"272486";"9942";"96,48";3552502
"Suzano";"2018";"285257";"139668";"145589";"95,93";"275215";"10042";"96,48";3552502
"Suzano";"2019";"288115";"141042";"147073";"95,9";"277973";"10142";"96,48";3552502
"Suzano";"2020";"291002";"142429";"148573";"95,86";"280758";"10244";"96,48";3552502
"Tabapuã";"2016";"11714";"5883";"5831";"100,89";"10950";"764";"93,48";3552601
"Tabapuã";"2017";"11759";"5901";"5858";"100,73";"11001";"758";"93,55";3552601
"Tabapuã";"2018";"11803";"5918";"5885";"100,56";"11050";"753";"93,62";3552601
"Tabapuã";"2019";"11847";"5935";"5912";"100,39";"11097";"750";"93,67";3552601
"Tabapuã";"2020";"11892";"5953";"5939";"100,24";"11145";"747";"93,72";3552601
"Tabatinga";"2016";"15423";"7902";"7521";"105,07";"13684";"1739";"88,72";3552700
"Tabatinga";"2017";"15540";"7956";"7584";"104,91";"13855";"1685";"89,16";3552700
"Tabatinga";"2018";"15658";"8010";"7648";"104,73";"14025";"1633";"89,57";3552700
"Tabatinga";"2019";"15777";"8065";"7712";"104,58";"14194";"1583";"89,97";3552700
"Tabatinga";"2020";"15897";"8120";"7777";"104,41";"14361";"1536";"90,34";3552700
"Taboão da Serra";"2016";"268325";"128635";"139690";"92,09";"268325";"-";"100";3552809
"Taboão da Serra";"2017";"272130";"130509";"141621";"92,15";"272130";"-";"100";3552809
"Taboão da Serra";"2018";"275988";"132409";"143579";"92,22";"275988";"-";"100";3552809
"Taboão da Serra";"2019";"279902";"134338";"145564";"92,29";"279902";"-";"100";3552809
"Taboão da Serra";"2020";"283871";"136294";"147577";"92,35";"283871";"-";"100";3552809
"Taciba";"2016";"5920";"2948";"2972";"99,19";"5137";"783";"86,77";3552908
"Taciba";"2017";"5954";"2963";"2991";"99,06";"5183";"771";"87,05";3552908
"Taciba";"2018";"5987";"2977";"3010";"98,9";"5229";"758";"87,34";3552908
"Taciba";"2019";"6020";"2991";"3029";"98,75";"5274";"746";"87,61";3552908
"Taciba";"2020";"6054";"3006";"3048";"98,62";"5320";"734";"87,88";3552908
"Taguaí";"2016";"12367";"6147";"6220";"98,83";"8860";"3507";"71,64";3553005
"Taguaí";"2017";"12598";"6261";"6337";"98,8";"9025";"3573";"71,64";3553005
"Taguaí";"2018";"12834";"6377";"6457";"98,76";"9194";"3640";"71,64";3553005
"Taguaí";"2019";"13074";"6495";"6579";"98,72";"9366";"3708";"71,64";3553005
"Taguaí";"2020";"13319";"6615";"6704";"98,67";"9542";"3777";"71,64";3553005
"Taiaçu";"2016";"5982";"2994";"2988";"100,2";"5523";"459";"92,33";3553104
"Taiaçu";"2017";"5996";"2998";"2998";"100";"5551";"445";"92,58";3553104
"Taiaçu";"2018";"6009";"3002";"3007";"99,83";"5577";"432";"92,81";3553104
"Taiaçu";"2019";"6023";"3006";"3017";"99,64";"5603";"420";"93,03";3553104
"Taiaçu";"2020";"6037";"3010";"3027";"99,44";"5629";"408";"93,24";3553104
"Taiúva";"2016";"6330";"3626";"2704";"134,1";"5886";"444";"92,99";3553203
"Taiúva";"2017";"6313";"3614";"2699";"133,9";"5885";"428";"93,22";3553203
"Taiúva";"2018";"6302";"3608";"2694";"133,93";"5890";"412";"93,46";3553203
"Taiúva";"2019";"6290";"3601";"2689";"133,92";"5892";"398";"93,67";3553203
"Taiúva";"2020";"6278";"3594";"2684";"133,9";"5894";"384";"93,88";3553203
"Tambaú";"2016";"22620";"11226";"11394";"98,53";"20459";"2161";"90,45";3553302
"Tambaú";"2017";"22666";"11240";"11426";"98,37";"20555";"2111";"90,69";3553302
"Tambaú";"2018";"22712";"11255";"11457";"98,24";"20650";"2062";"90,92";3553302
"Tambaú";"2019";"22757";"11269";"11488";"98,09";"20742";"2015";"91,15";3553302
"Tambaú";"2020";"22803";"11283";"11520";"97,94";"20834";"1969";"91,37";3553302
"Tanabi";"2016";"24750";"12357";"12393";"99,71";"22883";"1867";"92,46";3553401
"Tanabi";"2017";"24837";"12397";"12440";"99,65";"23014";"1823";"92,66";3553401
"Tanabi";"2018";"24926";"12438";"12488";"99,6";"23140";"1786";"92,83";3553401
"Tanabi";"2019";"25016";"12479";"12537";"99,54";"23262";"1754";"92,99";3553401
"Tanabi";"2020";"25105";"12520";"12585";"99,48";"23378";"1727";"93,12";3553401
"Tapiraí";"2016";"7765";"3898";"3867";"100,8";"5724";"2041";"73,72";3553500
"Tapiraí";"2017";"7749";"3886";"3863";"100,6";"5740";"2009";"74,07";3553500
"Tapiraí";"2018";"7732";"3874";"3858";"100,41";"5755";"1977";"74,43";3553500
"Tapiraí";"2019";"7716";"3862";"3854";"100,21";"5771";"1945";"74,79";3553500
"Tapiraí";"2020";"7699";"3850";"3849";"100,03";"5785";"1914";"75,14";3553500
"Tapiratiba";"2016";"12644";"6239";"6405";"97,41";"11023";"1621";"87,18";3553609
"Tapiratiba";"2017";"12635";"6227";"6408";"97,18";"11098";"1537";"87,84";3553609
"Tapiratiba";"2018";"12627";"6216";"6411";"96,96";"11169";"1458";"88,45";3553609
"Tapiratiba";"2019";"12618";"6204";"6414";"96,73";"11235";"1383";"89,04";3553609
"Tapiratiba";"2020";"12610";"6193";"6417";"96,51";"11298";"1312";"89,6";3553609
"Taquaral";"2016";"2735";"1376";"1359";"101,25";"2636";"99";"96,38";3553658
"Taquaral";"2017";"2739";"1377";"1362";"101,1";"2642";"97";"96,46";3553658
"Taquaral";"2018";"2743";"1379";"1364";"101,1";"2648";"95";"96,54";3553658
"Taquaral";"2019";"2747";"1380";"1367";"100,95";"2654";"93";"96,61";3553658
"Taquaral";"2020";"2751";"1382";"1369";"100,95";"2660";"91";"96,69";3553658
"Taquaritinga";"2016";"54262";"26726";"27536";"97,06";"51967";"2295";"95,77";3553708
"Taquaritinga";"2017";"54321";"26744";"27577";"96,98";"52089";"2232";"95,89";3553708
"Taquaritinga";"2018";"54381";"26763";"27618";"96,9";"52206";"2175";"96";3553708
"Taquaritinga";"2019";"54439";"26781";"27658";"96,83";"52316";"2123";"96,1";3553708
"Taquaritinga";"2020";"54499";"26800";"27699";"96,75";"52424";"2075";"96,19";3553708
"Taquarituba";"2016";"22865";"11378";"11487";"99,05";"20565";"2300";"89,94";3553807
"Taquarituba";"2017";"22947";"11418";"11529";"99,04";"20710";"2237";"90,25";3553807
"Taquarituba";"2018";"23029";"11458";"11571";"99,02";"20854";"2175";"90,56";3553807
"Taquarituba";"2019";"23111";"11498";"11613";"99,01";"20997";"2114";"90,85";3553807
"Taquarituba";"2020";"23193";"11538";"11655";"99";"21137";"2056";"91,14";3553807
"Taquarivaí";"2016";"5500";"2747";"2753";"99,78";"3118";"2382";"56,69";3553856
"Taquarivaí";"2017";"5560";"2776";"2784";"99,71";"3171";"2389";"57,03";3553856
"Taquarivaí";"2018";"5622";"2806";"2816";"99,64";"3226";"2396";"57,38";3553856
"Taquarivaí";"2019";"5684";"2836";"2848";"99,58";"3281";"2403";"57,72";3553856
"Taquarivaí";"2020";"5746";"2866";"2880";"99,51";"3337";"2409";"58,08";3553856
"Tarabai";"2016";"7004";"3476";"3528";"98,53";"6546";"458";"93,46";3553906
"Tarabai";"2017";"7070";"3507";"3563";"98,43";"6618";"452";"93,61";3553906
"Tarabai";"2018";"7135";"3538";"3597";"98,36";"6689";"446";"93,75";3553906
"Tarabai";"2019";"7202";"3569";"3633";"98,24";"6762";"440";"93,89";3553906
"Tarabai";"2020";"7269";"3601";"3668";"98,17";"6834";"435";"94,02";3553906
"Tarumã";"2016";"14059";"7154";"6905";"103,61";"13345";"714";"94,92";3553955
"Tarumã";"2017";"14242";"7243";"6999";"103,49";"13530";"712";"95";3553955
"Tarumã";"2018";"14428";"7332";"7096";"103,33";"13717";"711";"95,07";3553955
"Tarumã";"2019";"14615";"7422";"7193";"103,18";"13903";"712";"95,13";3553955
"Tarumã";"2020";"14806";"7514";"7292";"103,04";"14093";"713";"95,18";3553955
"Tatuí";"2016";"115049";"56731";"58318";"97,28";"111079";"3970";"96,55";3554003
"Tatuí";"2017";"116296";"57332";"58964";"97,23";"112476";"3820";"96,72";3554003
"Tatuí";"2018";"117558";"57940";"59618";"97,19";"113878";"3680";"96,87";3554003
"Tatuí";"2019";"118833";"58554";"60279";"97,14";"115285";"3548";"97,01";3554003
"Tatuí";"2020";"120123";"59175";"60948";"97,09";"116699";"3424";"97,15";3554003
"Taubaté";"2016";"296449";"145284";"151165";"96,11";"290373";"6076";"97,95";3554102
"Taubaté";"2017";"299140";"146573";"152567";"96,07";"293022";"6118";"97,95";3554102
"Taubaté";"2018";"301856";"147873";"153983";"96,03";"295692";"6164";"97,96";3554102
"Taubaté";"2019";"304596";"149184";"155412";"95,99";"298383";"6213";"97,96";3554102
"Taubaté";"2020";"307361";"150507";"156854";"95,95";"301096";"6265";"97,96";3554102
"Tejupá";"2016";"4716";"2404";"2312";"103,98";"3405";"1311";"72,2";3554201
"Tejupá";"2017";"4711";"2399";"2312";"103,76";"3454";"1257";"73,32";3554201
"Tejupá";"2018";"4707";"2395";"2312";"103,59";"3502";"1205";"74,4";3554201
"Tejupá";"2019";"4702";"2390";"2312";"103,37";"3548";"1154";"75,46";3554201
"Tejupá";"2020";"4697";"2385";"2312";"103,16";"3593";"1104";"76,5";3554201
"Teodoro Sampaio";"2016";"22026";"10921";"11105";"98,34";"18084";"3942";"82,1";3554300
"Teodoro Sampaio";"2017";"22122";"10960";"11162";"98,19";"18196";"3926";"82,25";3554300
"Teodoro Sampaio";"2018";"22219";"10998";"11221";"98,01";"18308";"3911";"82,4";3554300
"Teodoro Sampaio";"2019";"22316";"11037";"11279";"97,85";"18420";"3896";"82,54";3554300
"Teodoro Sampaio";"2020";"22414";"11076";"11338";"97,69";"18533";"3881";"82,68";3554300
"Terra Roxa";"2016";"8880";"4477";"4403";"101,68";"8522";"358";"95,97";3554409
"Terra Roxa";"2017";"8939";"4504";"4435";"101,56";"8585";"354";"96,04";3554409
"Terra Roxa";"2018";"8999";"4532";"4467";"101,46";"8650";"349";"96,12";3554409
"Terra Roxa";"2019";"9060";"4561";"4499";"101,38";"8714";"346";"96,18";3554409
"Terra Roxa";"2020";"9121";"4589";"4532";"101,26";"8779";"342";"96,25";3554409
"Tietê";"2016";"39431";"19517";"19914";"98,01";"35958";"3473";"91,19";3554508
"Tietê";"2017";"39836";"19712";"20124";"97,95";"36345";"3491";"91,24";3554508
"Tietê";"2018";"40244";"19909";"20335";"97,91";"36735";"3509";"91,28";3554508
"Tietê";"2019";"40656";"20107";"20549";"97,85";"37129";"3527";"91,32";3554508
"Tietê";"2020";"41073";"20308";"20765";"97,8";"37528";"3545";"91,37";3554508
"Timburi";"2016";"2587";"1329";"1258";"105,64";"1967";"620";"76,03";3554607
"Timburi";"2017";"2580";"1324";"1256";"105,41";"1975";"605";"76,55";3554607
"Timburi";"2018";"2572";"1319";"1253";"105,27";"1982";"590";"77,06";3554607
"Timburi";"2019";"2565";"1314";"1251";"105,04";"1990";"575";"77,58";3554607
"Timburi";"2020";"2557";"1309";"1248";"104,89";"1996";"561";"78,06";3554607
"Torre de Pedra";"2016";"2293";"1197";"1096";"109,22";"1579";"714";"68,86";3554656
"Torre de Pedra";"2017";"2299";"1199";"1100";"109";"1596";"703";"69,42";3554656
"Torre de Pedra";"2018";"2307";"1202";"1105";"108,78";"1615";"692";"70";3554656
"Torre de Pedra";"2019";"2313";"1204";"1109";"108,57";"1633";"680";"70,6";3554656
"Torre de Pedra";"2020";"2320";"1206";"1114";"108,26";"1651";"669";"71,16";3554656
"Torrinha";"2016";"9558";"4789";"4769";"100,42";"8265";"1293";"86,47";3554706
"Torrinha";"2017";"9597";"4804";"4793";"100,23";"8320";"1277";"86,69";3554706
"Torrinha";"2018";"9635";"4818";"4817";"100,02";"8374";"1261";"86,91";3554706
"Torrinha";"2019";"9675";"4833";"4842";"99,81";"8429";"1246";"87,12";3554706
"Torrinha";"2020";"9713";"4847";"4866";"99,61";"8482";"1231";"87,33";3554706
"Trabiju";"2016";"1637";"813";"824";"98,67";"1523";"114";"93,04";3554755
"Trabiju";"2017";"1653";"820";"833";"98,44";"1541";"112";"93,22";3554755
"Trabiju";"2018";"1670";"827";"843";"98,1";"1559";"111";"93,35";3554755
"Trabiju";"2019";"1686";"834";"852";"97,89";"1577";"109";"93,53";3554755
"Trabiju";"2020";"1703";"841";"862";"97,56";"1595";"108";"93,66";3554755
"Tremembé";"2016";"44174";"23036";"21138";"108,98";"40642";"3532";"92";3554805
"Tremembé";"2017";"44617";"23244";"21373";"108,75";"41170";"3447";"92,27";3554805
"Tremembé";"2018";"45066";"23455";"21611";"108,53";"41700";"3366";"92,53";3554805
"Tremembé";"2019";"45519";"23667";"21852";"108,31";"42232";"3287";"92,78";3554805
"Tremembé";"2020";"45978";"23882";"22096";"108,08";"42766";"3212";"93,01";3554805
"Três Fronteiras";"2016";"5503";"2744";"2759";"99,46";"4798";"705";"87,19";3554904
"Três Fronteiras";"2017";"5514";"2747";"2767";"99,28";"4827";"687";"87,54";3554904
"Três Fronteiras";"2018";"5525";"2751";"2774";"99,17";"4854";"671";"87,86";3554904
"Três Fronteiras";"2019";"5536";"2754";"2782";"98,99";"4882";"654";"88,19";3554904
"Três Fronteiras";"2020";"5547";"2758";"2789";"98,89";"4908";"639";"88,48";3554904
"Tuiuti";"2016";"6325";"3196";"3129";"102,14";"3328";"2997";"52,62";3554953
"Tuiuti";"2017";"6382";"3220";"3162";"101,83";"3385";"2997";"53,04";3554953
"Tuiuti";"2018";"6439";"3245";"3194";"101,6";"3442";"2997";"53,46";3554953
"Tuiuti";"2019";"6499";"3271";"3228";"101,33";"3501";"2998";"53,87";3554953
"Tuiuti";"2020";"6557";"3296";"3261";"101,07";"3560";"2997";"54,29";3554953
"Tupã";"2016";"63057";"30444";"32613";"93,35";"60528";"2529";"95,99";3555000
"Tupã";"2017";"63004";"30409";"32595";"93,29";"60477";"2527";"95,99";3555000
"Tupã";"2018";"62950";"30374";"32576";"93,24";"60425";"2525";"95,99";3555000
"Tupã";"2019";"62897";"30339";"32558";"93,18";"60374";"2523";"95,99";3555000
"Tupã";"2020";"62843";"30304";"32539";"93,13";"60322";"2521";"95,99";3555000
"Tupi Paulista";"2016";"14783";"7658";"7125";"107,48";"11610";"3173";"78,54";3555109
"Tupi Paulista";"2017";"14805";"7664";"7141";"107,32";"11627";"3178";"78,53";3555109
"Tupi Paulista";"2018";"14829";"7671";"7158";"107,17";"11646";"3183";"78,54";3555109
"Tupi Paulista";"2019";"14851";"7677";"7174";"107,01";"11663";"3188";"78,53";3555109
"Tupi Paulista";"2020";"14878";"7686";"7192";"106,87";"11685";"3193";"78,54";3555109
"Turiúba";"2016";"1923";"988";"935";"105,67";"1607";"316";"83,57";3555208
"Turiúba";"2017";"1921";"986";"935";"105,45";"1610";"311";"83,81";3555208
"Turiúba";"2018";"1917";"983";"934";"105,25";"1612";"305";"84,09";3555208
"Turiúba";"2019";"1915";"981";"934";"105,03";"1615";"300";"84,33";3555208
"Turiúba";"2020";"1912";"979";"933";"104,93";"1618";"294";"84,62";3555208
"Turmalina";"2016";"1869";"919";"950";"96,74";"1386";"483";"74,16";3555307
"Turmalina";"2017";"1852";"909";"943";"96,39";"1383";"469";"74,68";3555307
"Turmalina";"2018";"1836";"900";"936";"96,15";"1379";"457";"75,11";3555307
"Turmalina";"2019";"1821";"891";"930";"95,81";"1376";"445";"75,56";3555307
"Turmalina";"2020";"1805";"882";"923";"95,56";"1373";"432";"76,07";3555307
"Ubarana";"2016";"5764";"2936";"2828";"103,82";"5312";"452";"92,16";3555356
"Ubarana";"2017";"5838";"2970";"2868";"103,56";"5384";"454";"92,22";3555356
"Ubarana";"2018";"5914";"3005";"2909";"103,3";"5459";"455";"92,31";3555356
"Ubarana";"2019";"5989";"3040";"2949";"103,09";"5532";"457";"92,37";3555356
"Ubarana";"2020";"6066";"3075";"2991";"102,81";"5608";"458";"92,45";3555356
"Ubatuba";"2016";"84872";"41989";"42883";"97,92";"82870";"2002";"97,64";3555406
"Ubatuba";"2017";"85866";"42448";"43418";"97,77";"83846";"2020";"97,65";3555406
"Ubatuba";"2018";"86870";"42911";"43959";"97,62";"84833";"2037";"97,66";3555406
"Ubatuba";"2019";"87887";"43380";"44507";"97,47";"85832";"2055";"97,66";3555406
"Ubatuba";"2020";"88916";"43854";"45062";"97,32";"86842";"2074";"97,67";3555406
"Ubirajara";"2016";"4570";"2352";"2218";"106,04";"3356";"1214";"73,44";3555505
"Ubirajara";"2017";"4593";"2363";"2230";"105,96";"3376";"1217";"73,5";3555505
"Ubirajara";"2018";"4616";"2374";"2242";"105,89";"3397";"1219";"73,59";3555505
"Ubirajara";"2019";"4640";"2386";"2254";"105,86";"3418";"1222";"73,66";3555505
"Ubirajara";"2020";"4663";"2397";"2266";"105,78";"3439";"1224";"73,75";3555505
"Uchoa";"2016";"9607";"4757";"4850";"98,08";"8994";"613";"93,62";3555604
"Uchoa";"2017";"9626";"4763";"4863";"97,94";"9017";"609";"93,67";3555604
"Uchoa";"2018";"9645";"4769";"4876";"97,81";"9039";"606";"93,72";3555604
"Uchoa";"2019";"9664";"4775";"4889";"97,67";"9061";"603";"93,76";3555604
"Uchoa";"2020";"9683";"4781";"4902";"97,53";"9082";"601";"93,79";3555604
"União Paulista";"2016";"1686";"873";"813";"107,38";"1331";"355";"78,94";3555703
"União Paulista";"2017";"1698";"879";"819";"107,33";"1347";"351";"79,33";3555703
"União Paulista";"2018";"1712";"886";"826";"107,26";"1365";"347";"79,73";3555703
"União Paulista";"2019";"1725";"892";"833";"107,08";"1381";"344";"80,06";3555703
"União Paulista";"2020";"1739";"899";"840";"107,02";"1399";"340";"80,45";3555703
"Urânia";"2016";"8710";"4316";"4394";"98,22";"7496";"1214";"86,06";3555802
"Urânia";"2017";"8685";"4301";"4384";"98,11";"7500";"1185";"86,36";3555802
"Urânia";"2018";"8660";"4287";"4373";"98,03";"7502";"1158";"86,63";3555802
"Urânia";"2019";"8636";"4273";"4363";"97,94";"7504";"1132";"86,89";3555802
"Urânia";"2020";"8611";"4259";"4352";"97,86";"7504";"1107";"87,14";3555802
"Uru";"2016";"1219";"621";"598";"103,85";"1117";"102";"91,63";3555901
"Uru";"2017";"1217";"619";"598";"103,51";"1123";"94";"92,28";3555901
"Uru";"2018";"1213";"616";"597";"103,18";"1126";"87";"92,83";3555901
"Uru";"2019";"1211";"614";"597";"102,85";"1130";"81";"93,31";3555901
"Uru";"2020";"1207";"611";"596";"102,52";"1132";"75";"93,79";3555901
"Urupês";"2016";"12997";"6434";"6563";"98,03";"11824";"1173";"90,97";3556008
"Urupês";"2017";"13039";"6450";"6589";"97,89";"11894";"1145";"91,22";3556008
"Urupês";"2018";"13081";"6466";"6615";"97,75";"11962";"1119";"91,45";3556008
"Urupês";"2019";"13122";"6482";"6640";"97,62";"12027";"1095";"91,66";3556008
"Urupês";"2020";"13164";"6498";"6666";"97,48";"12090";"1074";"91,84";3556008
"Valentim Gentil";"2016";"12106";"6064";"6042";"100,36";"11185";"921";"92,39";3556107
"Valentim Gentil";"2017";"12268";"6142";"6126";"100,26";"11351";"917";"92,53";3556107
"Valentim Gentil";"2018";"12433";"6221";"6212";"100,14";"11519";"914";"92,65";3556107
"Valentim Gentil";"2019";"12601";"6301";"6300";"100,02";"11689";"912";"92,76";3556107
"Valentim Gentil";"2020";"12770";"6382";"6388";"99,91";"11859";"911";"92,87";3556107
"Valinhos";"2016";"118947";"58531";"60416";"96,88";"113535";"5412";"95,45";3556206
"Valinhos";"2017";"120369";"59211";"61158";"96,82";"114947";"5422";"95,5";3556206
"Valinhos";"2018";"121809";"59899";"61910";"96,75";"116377";"5432";"95,54";3556206
"Valinhos";"2019";"123268";"60596";"62672";"96,69";"117825";"5443";"95,58";3556206
"Valinhos";"2020";"124742";"61300";"63442";"96,62";"119288";"5454";"95,63";3556206
"Valparaíso";"2016";"23438";"12797";"10641";"120,26";"22687";"751";"96,8";3556305
"Valparaíso";"2017";"23574";"12860";"10714";"120,03";"22859";"715";"96,97";3556305
"Valparaíso";"2018";"23711";"12923";"10788";"119,79";"23026";"685";"97,11";3556305
"Valparaíso";"2019";"23849";"12987";"10862";"119,56";"23191";"658";"97,24";3556305
"Valparaíso";"2020";"23988";"13051";"10937";"119,33";"23353";"635";"97,35";3556305
"Vargem";"2016";"9531";"4855";"4676";"103,83";"5524";"4007";"57,96";3556354
"Vargem";"2017";"9646";"4907";"4739";"103,55";"5712";"3934";"59,22";3556354
"Vargem";"2018";"9762";"4960";"4802";"103,29";"5902";"3860";"60,46";3556354
"Vargem";"2019";"9881";"5014";"4867";"103,02";"6095";"3786";"61,68";3556354
"Vargem";"2020";"10000";"5068";"4932";"102,76";"6290";"3710";"62,9";3556354
"Vargem Grande do Sul";"2016";"40652";"20113";"20539";"97,93";"38935";"1717";"95,78";3556404
"Vargem Grande do Sul";"2017";"40863";"20208";"20655";"97,84";"39186";"1677";"95,9";3556404
"Vargem Grande do Sul";"2018";"41075";"20303";"20772";"97,74";"39436";"1639";"96,01";3556404
"Vargem Grande do Sul";"2019";"41287";"20398";"20889";"97,65";"39684";"1603";"96,12";3556404
"Vargem Grande do Sul";"2020";"41501";"20494";"21007";"97,56";"39933";"1568";"96,22";3556404
"Vargem Grande Paulista";"2016";"48905";"24227";"24678";"98,17";"48905";"-";"100";3556453
"Vargem Grande Paulista";"2017";"49842";"24684";"25158";"98,12";"49842";"-";"100";3556453
"Vargem Grande Paulista";"2018";"50797";"25150";"25647";"98,06";"50797";"-";"100";3556453
"Vargem Grande Paulista";"2019";"51770";"25624";"26146";"98";"51770";"-";"100";3556453
"Vargem Grande Paulista";"2020";"52762";"26108";"26654";"97,95";"52762";"-";"100";3556453
"Várzea Paulista";"2016";"115562";"57489";"58073";"98,99";"115562";"-";"100";3556503
"Várzea Paulista";"2017";"116785";"58072";"58713";"98,91";"116785";"-";"100";3556503
"Várzea Paulista";"2018";"118022";"58662";"59360";"98,82";"118022";"-";"100";3556503
"Várzea Paulista";"2019";"119272";"59257";"60015";"98,74";"119272";"-";"100";3556503
"Várzea Paulista";"2020";"120535";"59859";"60676";"98,65";"120535";"-";"100";3556503
"Vera Cruz";"2016";"10604";"5194";"5410";"96,01";"9421";"1183";"88,84";3556602
"Vera Cruz";"2017";"10584";"5182";"5402";"95,93";"9433";"1151";"89,13";3556602
"Vera Cruz";"2018";"10564";"5170";"5394";"95,85";"9443";"1121";"89,39";3556602
"Vera Cruz";"2019";"10544";"5158";"5386";"95,77";"9452";"1092";"89,64";3556602
"Vera Cruz";"2020";"10524";"5146";"5378";"95,69";"9460";"1064";"89,89";3556602
"Vinhedo";"2016";"72287";"35701";"36586";"97,58";"70015";"2272";"96,86";3556701
"Vinhedo";"2017";"73561";"36319";"37242";"97,52";"71249";"2312";"96,86";3556701
"Vinhedo";"2018";"74858";"36948";"37910";"97,46";"72506";"2352";"96,86";3556701
"Vinhedo";"2019";"76178";"37587";"38591";"97,4";"73784";"2394";"96,86";3556701
"Vinhedo";"2020";"77521";"38238";"39283";"97,34";"75085";"2436";"96,86";3556701
"Viradouro";"2016";"17952";"9011";"8941";"100,78";"17427";"525";"97,08";3556800
"Viradouro";"2017";"18050";"9056";"8994";"100,69";"17522";"528";"97,07";3556800
"Viradouro";"2018";"18148";"9101";"9047";"100,6";"17617";"531";"97,07";3556800
"Viradouro";"2019";"18247";"9146";"9101";"100,49";"17713";"534";"97,07";3556800
"Viradouro";"2020";"18347";"9192";"9155";"100,4";"17810";"537";"97,07";3556800
"Vista Alegre do Alto";"2016";"7595";"3887";"3708";"104,83";"7137";"458";"93,97";3556909
"Vista Alegre do Alto";"2017";"7697";"3936";"3761";"104,65";"7250";"447";"94,19";3556909
"Vista Alegre do Alto";"2018";"7802";"3986";"3816";"104,45";"7365";"437";"94,4";3556909
"Vista Alegre do Alto";"2019";"7907";"4036";"3871";"104,26";"7479";"428";"94,59";3556909
"Vista Alegre do Alto";"2020";"8014";"4087";"3927";"104,07";"7594";"420";"94,76";3556909
"Vitória Brasil";"2016";"1752";"892";"860";"103,72";"1521";"231";"86,82";3556958
"Vitória Brasil";"2017";"1755";"892";"863";"103,36";"1533";"222";"87,35";3556958
"Vitória Brasil";"2018";"1756";"891";"865";"103,01";"1543";"213";"87,87";3556958
"Vitória Brasil";"2019";"1759";"891";"868";"102,65";"1554";"205";"88,35";3556958
"Vitória Brasil";"2020";"1760";"890";"870";"102,3";"1562";"198";"88,75";3556958
"Votorantim";"2016";"115495";"57225";"58270";"98,21";"111090";"4405";"96,19";3557006
"Votorantim";"2017";"116562";"57738";"58824";"98,15";"112116";"4446";"96,19";3557006
"Votorantim";"2018";"117640";"58255";"59385";"98,1";"113153";"4487";"96,19";3557006
"Votorantim";"2019";"118727";"58777";"59950";"98,04";"114199";"4528";"96,19";3557006
"Votorantim";"2020";"119824";"59303";"60521";"97,99";"115254";"4570";"96,19";3557006
"Votuporanga";"2016";"89124";"43413";"45711";"94,97";"86627";"2497";"97,2";3557105
"Votuporanga";"2017";"89776";"43723";"46053";"94,94";"87261";"2515";"97,2";3557105
"Votuporanga";"2018";"90432";"44034";"46398";"94,9";"87898";"2534";"97,2";3557105
"Votuporanga";"2019";"91094";"44348";"46746";"94,87";"88542";"2552";"97,2";3557105
"Votuporanga";"2020";"91760";"44664";"47096";"94,84";"89189";"2571";"97,2";3557105
"Zacarias";"2016";"2478";"1236";"1242";"99,52";"2057";"421";"83,01";3557154
"Zacarias";"2017";"2498";"1244";"1254";"99,2";"2089";"409";"83,63";3557154
"Zacarias";"2018";"2518";"1253";"1265";"99,05";"2120";"398";"84,19";3557154
"Zacarias";"2019";"2539";"1262";"1277";"98,83";"2152";"387";"84,76";3557154
"Zacarias";"2020";"2560";"1271";"1289";"98,6";"2183";"377";"85,27";3557154
